The boys are playing ball.	Ꮎ ᎠᏂᏧᏣ ᏍᏆᏞᏍᏗ ᏓᎾᏁᎶᎲᏍᎦ.
Roosters crow at dawn.	ᏥᏔᎦ ᎠᏂᏨᏯ ᎤᎩᏥᏍᏕᏱ ᎠᎾᏴᎪᎢ.
How much does one rick of wood cost?	ᎯᎳ ᏧᎬᏩᎶᏗ ᏌᏊ ᎢᎦᏒᏘ ᎠᏓ?
He's thinking about raising chicks.	ᏥᏔᎦ ᎠᏂᏓ ᏧᏛᎯᏍᏙᏗ ᎠᏓᏅᏖᎭ.
When he threw the ball down, it bounced.	ᎡᎳᏗ ᏭᏗᎾ ᏍᏆᏞᏍᏗ ᎤᏓᏗᏅᏒᎢ.
I see a lame man limping.	ᎠᏲᎤᏟᎠ ᎠᏍᎦᏯ ᎠᏓᏕᎬ ᏥᎪᏮᏘᎭ.
The ball player is bouncing the ball hard.	Ꮎ ᎠᎳᏍᎦᎵᏍᎩ ᏍᏓᏱ ᎠᏓᏗᏅᏗᎭ ᏍᏆᏞᏍᏗ.
She put on a pretty belt when she went to town.	ᎤᏬᏚᎯ ᎠᏓᏠᏍᏗ ᎤᏓᏠᏢᎢ ᏗᎦᏚᎲ ᎤᏪᎾ.
I got a belt for Christmas.	ᎠᏓᏠᏍᏗ ᎠᎩᏁᏒ ᏓᏂᏍᏓᏲᎯᎲᎢ.
The preacher asked for prayers.	ᎠᏓᏙᎵᏍᏗ ᎤᏔᏲᏢ ᎠᎵᏣᏙᎲᏍᎩ.
He prays three times a day.	ᏦᎢ ᎢᏳᏩᎩᏗ ᎠᏓᏙᎵᏍᏗᏍᎪ ᏏᎦ.
She bought tender green beans at the store. A very young child drinks only milk.	ᎠᏂᏓᎨ ᏚᏯ ᎠᏂᏤ ᏚᏩᏒ ᏗᏓᎾᏅᎢ. ᎠᏓᎨ ᎠᏲᏟ ᎤᏅᏗᏊ ᎢᎦ ᎠᏗᏔᏍᎪᎢ
Love is important.	ᎠᏓᎨᏴᏗ ᎤᎵᏍᎨᏓ.
Some pills are killers if too many are swallowed.	ᎢᎦᏓ ᏗᎩᏍᏗ ᎠᎾᏓᎯᎯ ᏥᏈᏍᏗ ᏱᏓᎩᏌ.
He gave his wife a new purse.	ᎢᏤ ᎠᏓᏟᏁᏌᎵᏗ ᎤᏅᏁᎸ ᎤᏍᏓᏴᎲᏍᎩ.
When it's close to Christmas, people shop for gifts.	ᏓᏂᏍᏓᏲᎯᎲ ᎾᎥ ᏱᎩ, ᏗᏓᏁᏗ ᎠᎾᏓᏁᎠᏁᏒᎲᏍᎪ ᏴᏫ.
She wants to fan herself, but she has no fan.	ᎤᏓᏃᏰᏗ ᎤᏚᎵ ᎠᏎᏅ Ꮭ ᎠᏓᏃᏲ ᏳᏩᏯ.
It's hot. Plug in the fan.	ᎤᏗᏞᎦ. ᎱᏓᎸᎥᎦ ᎠᏓᏃᏲ.
This isn't my home. I'm just visiting.	Ꮭ ᎠᏴ ᎠᏇᏅᏒ ᏱᎩ ᎠᎭᏂ. ᎦᏓᏩᏛᎯᏙᎭᏊ.
When he finished writing letters, he stretched.	ᎤᏍᏆᏓ ᎪᏪᎵ ᏕᎪᏪᎵᏍᎬ, ᎤᏓᏯᏍᏔᏅᎢ.
He was cured of his cancer.	ᎠᏓᏰᏍᎩ ᎤᏢᎬ ᎠᏥᏅᏩᏅᎢ.
When he was accused of stealing, he denied it. I am denying him because I don't know him.	ᎤᏃᏍᎩᏒ ᎠᎫᎢᏍᏔᎾ, ᎤᏓᏱᎸᎢ. ᏥᏯᏓᏱᎭ, ᏝᎮᏃ ᏱᏥᏲᎵᎦ.
The eighth commandment says, "Thou shalt not commit adultery."	ᏣᏁᎵᏁ ᏗᎧᏃᏩᏛᏍᏗ "ᏞᏍᏗ ᏣᏓᏲᏁᎸᎢ" ᎠᏗᎭ.
The Bible reproves adultery.	ᎦᎸᏉᏗ ᎪᏪᎵ ᎠᏍᎦᎦ ᎠᏓᏲᏁᏗ.
An adulteress is mentioned in chapter eight of the book of John.	ᏣᏂ ᎣᏍᏓ ᎧᏃᎮᏛ ᏣᏁᎵᏁ ᎠᏯᏙᏢ ᎠᏥᏁᎢᏍᏗ ᎠᏓᏲᏁᎯ ᎠᎨᏯ.
An old cloth is easy to rip.	ᎤᏪᏘ ᎠᎿᏬ ᎠᎯᏓ ᎨᏐ ᎤᏓᏣᎦᎵᏗ.
Some kind of a stinging bug stung him on his hand.	ᎪᎱᏍᏓ ᎤᏍᏗ ᏥᏍᎪᏯ ᎠᏓᏨᎢᏍᎩ ᎤᏩᏨᏴ ᎤᏬᏰᏂ.
When he's getting ready to go somewhere, he uses a mirror.	Ꮲ ᎤᏪᏄᏍᏗ ᏯᏛᏅᎢᏍᏗ ᎠᏓᎨᏍᎪᎢ.
She has a big mirror on the dresser.	ᎤᏔᎾ ᎠᏓᎨᏗ ᏄᏩᏅᏗ ᏗᏎᎯᏍᏗᎢ.
When it's time for them to play ball, the ball game begins.	ᎤᎾᎳᏍᎦᏗ ᏳᏟᎢᎶᏝ ᎠᏓᎴᏂᏍᎪ ᎠᎾᎳᏍᎦᎵᏍᎬᎢ.
She wants to do a lot of shopping, but the prices are too high.	ᏥᏈᏍᏗ ᎤᏓᎾᏁᏒᎲᏍᏗ ᎤᏚᎵ ᎠᏎᏅ ᏥᏈᏍᏗ ᏓᎬᏩᎶᏗᏓᎾ.
I work in a store in the summer.	ᎠᏓᎾᏅ ᏓᎩᎸᏫᏍᏓᏁᎰ ᎪᎩ ᏱᏄᎵᏍᏔᎾ.
When he heard the dog bark, he ran.	ᎩᏟ ᏓᏑᏩᏍᎬ ᎤᏛᎦᎾ, ᎤᏓᏄᏩᏍᏔᏅᎢ.
The red light just changed.	ᎩᎦᎨ ᎠᏨᏍᏛ ᎠᏓᏁᏟᏴᎾ.
When he got tired of guarding the prisoner, his friend took his place.	ᏚᏯᏪᏣ ᎠᏴᎩ ᎠᎦᏘᏴ, ᎠᎾᎵᎢ ᎤᏓᏁᏟᏴᏍᏔᏅᎢ.
The ball players always have substitutes.	ᎠᎾᏓᏁᏟᏴᏍᏗᏍᎩ ᏓᎾᏘᏁᎰ ᎠᎾᎳᏍᎦᎵᏍᎩ.
He gave a supply of food to the hungry.	ᎠᎵᏍᏓᏴᏗ ᎠᏓᏁᏢ ᏚᏁᎸ ᏧᏂᏲᏏᏍᎩ.
A tornado destroyed a building.	ᎤᏃᎴ ᎤᏲᏍᏔᏃᏅ ᎠᏓᏁᎸᎢ.
When the heart stops, a person dies.	ᎠᏓᏅᏙ ᏳᎴᏫᏍᏔᎾ, ᎠᏲᎱᏍᎪ ᏴᏫ.
What are you thinking about?	ᎦᏙ ᎤᏍᏗ ᎭᏓᏅᏖᎭ?
I'm just giving you something to think about.	ᎪᏍᏗᏊ ᎢᏣᏓᏅᏖᏗ ᎢᏨᏁᎭ.
He's considering something I told him.	ᎪᏍᏗ ᏥᏃᎯᏎᎸ ᎠᏓᏅᏖᎯᎶᎠ.
When you get close to a beaver, it makes noise.	ᏙᏯ ᎾᎥ ᏱᎦᎷᏤᎳ ᎤᏓᏃᏴᏟᏍᏗᏍᎪᎢ.
A big snake is crawling.	ᎤᏔᎾ ᎢᎾᏓ ᎠᏓᎾᏏᏂ.
When the twister hit the tree, it twisted.	ᎠᎦᎷᎦ ᎤᏩᏂᎳ ᏡᎬᎢ ᎤᏓᏄᏖᏲᎸᎢ.
He lived in Tahlequah for ten years, the he wanted to move.	ᏍᎪᎯ ᏧᏕᏘᏴᏓ ᎤᏁᎳᏛᎢ ᏓᎵᏆ, ᎩᎳ ᎤᏚᎷᎲ ᎤᏓᏅᏍᏗᎢ.
He orders a new car every year.	ᏑᏕᏘᏴᏓ ᎢᏳᏓᎵ ᎢᏤ ᏓᏆᎴᎳ ᎠᏓᏅᏍᎪᎢ.
She's in the kitchen washing dishes.	ᎠᏓᏍᏓᏴᏗ ᎠᏯᎠ ᏗᏖᎵᏙ ᏕᎬᏗᏰᎠ.
You don't have to cook, because I'm not hungry.	Ꮭ ᎠᏎ ᏣᏓᏍᏓᏴᏗ ᏱᎩ, ᏝᎮᏃ ᏯᎩᎪᏏᎭ.
z	x
Some Cherokees are very magical.	ᏙᏳ ᎠᏂᏓᏪᎯ ᎨᏐ ᎢᎦᏓ ᎠᏂᏣᎳᎩ.
The match is burning.	ᎠᏥᎳ ᎪᏢᏗ ᎠᏓᏪᎳᎩᎠ.
The flame burned his back.	ᎠᏓᏪᎳᎩᏍᎩ ᏚᎴᏴᏔᏅ ᎦᏐᎯᎢ.
My dad has worked at a place where they make gunpowder.	ᎠᏓᏪᎳᎩᏍᎩ ᎤᏃᏢᏗ ᏧᎸᏫᏍᏓᏁᎸ ᎡᏙᏓ.
Rest. You'll get exhausted.	ᎭᏓᏪᏐᎸᏍᏓ. ᏙᏔᏍᏔᏰᏎᎦ.
A man named Adam wants to speak to you.	ᎠᏓᏫ ᏧᏙᎢᏓ ᎠᏍᎦᏯ ᎤᏚᎵ ᏍᏓᏟᏃᎮᏗ.
Do you like to swim?	ᏣᎸᏉᏗᏍ ᏣᏓᏬᏍᏗ?
I like to swim in a creek more than in a swimming pool.	ᎤᏪᏴ ᎠᏆᏓᏬᏍᏗ ᎤᎪᏗ ᎠᎩᎸᏉᏗ ᏏᏅ ᎠᏓᏬᏍᏗ ᎨᏒᎢ.
Where did you get the color television?	ᎭᏢ ᏣᎩᏎ Ꮎ ᎤᎵᏑᏫᏓ ᎠᏓᏴᎳᏛᏍᎩ?
He gave the students a new pencil.	ᎢᏤ ᏗᎪᏪᎶᏗ ᎤᏕᎸ ᏗᏕᏠᏆᏍᎩ.
Is it easy to learn to speak Cherokee?	ᎠᎯᏓᏍ ᎠᏕᎶᏆᏍᏗ ᏣᎳᎩ ᎦᏬᏂᎯᏍᏗ?
She's trying to embarrass him.	ᎤᏕᎰᎯᏍᏙᏗ ᎠᏁᏟᏗᎭ.
When the girl winked at him, he got embarrassed.	ᎠᎨᏳᏣ ᎤᎦᏔᏍᏓᏁᎳ ᎤᏕᎰᏒᎢ.
He was born at five o'clock this morning.	ᎯᏍᎩ ᎢᏳᏩᏂᎸ ᏥᎨᏒ ᎪᎯ ᏑᎾᎴ ᎤᏕᏅᎢ.
The love of money is the root of evil."	"ᎠᏕᎳ ᎠᎨᏴᏗ ᎨᏒ ᏗᏓᎴᏂ ᎠᏍᎦᏂ."
Would you like to work in a bank?	ᏱᏣᏚᎳᏍ ᎠᏕᎵᏗᏴᏗ ᏗᏣᎸᏫᏍᏓᏁᏗ?
She wants to go to California.	ᎠᏕᎵᏧᏢ ᎤᏪᏅᏍᏗ ᎤᏚᎵᎭ.
He found out that he was being cheated.	ᎤᏕᎶᎰᏒ ᎠᏥᎶᏄᎡᏍᎬᎢ.
The price of this hat is ten dollars.	ᎯᎠ ᎠᎵᏍᏇᏚᏬ ᏍᎪ ᎠᏕᎸ ᏧᎬᏩᏟᏗ.
I like to dive when I'm swimming.	ᎠᏆᏕᏘᏗ ᎠᎩᎸᏉᏗ ᏱᎦᏓᏬᎠ.
I am circling a building.	ᎠᏓᏁᎸ ᎦᏕᏲᎭ.
Because he was driving fast, he missed the curve.	ᎠᏯᏄᎵ ᎠᎯᎵᏒ ᎢᏳᏍᏗ ᏚᏅᏛ ᎠᏕᏲᎲᎢ.
I am going to lay this fishing pole here.	ᎠᎭᏂ ᏓᏥᏗ ᎯᎠ ᏍᏗ.
I rise at six a.m.	ᏑᏓᎵ ᎢᏳᏩᏂᎸ ᏑᎾᎴ ᎦᏗᏗᏍᎪᎢ.
He scattered the papers on the table when he looked for his pencil.	ᏗᎪᏪᎵ ᎦᏍᎩᎸ ᏚᏝᎥ ᏚᏗᎦᎴᏴ ᏗᎪᏪᎶᏓ ᎤᏯᎳ.
Pieces of cloth scattered when the wind blew hard.	ᎠᎿᏬ ᎤᎵᎬᎭᎷᏴ ᎤᏗᎦᎴᏲᏨ ᏍᏓᏯ ᎤᏃᎸᎾ.
The wheel is spinning too fast to stop.	ᎠᏯᏄᎵ ᎠᏗᏆᎸᏕᏲᎭ ᎦᏉᏛ ᎠᎴᏫᏍᏙᏙᏗᎢ.
What is he saying?	ᎦᏙ ᎤᏍᏗ ᎠᏗᎭ?
Crossing the road, I was almost run over by a car.	ᏅᏃᎯ ᏕᏥᎾᏗᏫᏍᎬ ᎠᎴ ᏓᏆᎴᎳ ᎾᏆᏗᏅᏔᏅᎢ.
When the killer saw the police he hid.	ᏗᎾᏓᏂᏰᏍᎩ ᏚᎪᎭ ᏗᏓᎯᎯ ᎤᏗᏍᎦᎳᏅᎢ.
Leave the chair. There isn't room to put it in the car.	ᎯᏗᏏᏯ ᎦᏍᎩᎶ. Ꮭ ᏳᏜᏅᏓ ᎦᎳᏗᏍᏗ ᏓᏆᎴᎷᎢ.
What kind of a drink do you want?	ᎦᏙ ᎤᏍᏗ ᎠᏗᏔᏍᏗ ᏣᏚᎵ?
Camels drink a lot of water.	ᎨᎻᎵ ᏥᏈᏍᏗ ᎠᎹ ᎠᎾᏗᏔᏍᎪᎢ.
He's drinking soup with a spoon.	ᎠᏗᏙᏗ ᎬᏗ ᎠᏗᏔᏍᎦ ᎤᎦᎹ.
I see smoke from burning rubber.	ᎠᏜ ᎠᎪᎲᏍᎬ ᏚᎦᏒᏍᏛ ᏥᎪᏩᏘᎭ.
The boy is scratching where a mosquito bit him.	ᏙᏌ ᎤᏍᎦᎯᏨ ᎠᏜᎪᏍᎦ ᎠᏧᏣ.
The money is in the coat pocket.	ᎦᏌᎴᏂ ᎠᏜᏩᏛ ᏕᎦᏝ ᎠᏕᎳ.
Where did he turn off?	ᎭᏢ ᎢᏴ ᎤᏞᏎᎢ.
He wanted to take revenge against him but he didn't do it.	ᎤᏞᏤᏗ ᎤᏚᎸᎲ ᎠᏎᏍᎩᏂ Ꮭ ᎥᏍᎩ ᏰᏄᏛᏁᎴᎢ.
Don't be looking for revenge.	ᎮᏍᏗ ᎠᏞᎢᏍᏗ ᏰᏣᏲᎮᏍᏗ.
She puts on an apron when she works in the kitchen.	ᎠᏞᏌᏙ ᎠᏞᏌᏛᎢᏍᎪ ᎠᏓᏍᏓᏴᏗ ᏱᏚᎸᏪᏍᏓᏁᎳ.
I didn't see the turn-off.	Ꮭ ᏱᏥᎪᏩᏔ ᎠᏞᏍᎬᎢ.
What is she pouring? Milk or water?	ᎦᏙ ᎤᏍᏗ ᎠᏟᎠ. ᎠᎹ, ᎤᏅᏗᎨ?
They have some pretty earrings at the Cherokee Arts and Crafts in Tahlequah.	ᏧᏬᏚᎯ ᏗᏟᎠᏙ ᏚᏂᎭ ᎠᏂᏣᎳᎩ ᎤᏃᏢᏅᏅ ᎤᎾᏓᎾᏅᎢ ᏓᎵᏆ.
While I was swimming, water filled my ear.	ᎦᏓᏬᏍᎬ, ᎠᎹ ᎤᏟᏨ ᏥᎴᏂ.
He's drawing water from the barrel.	ᎠᎹ ᎠᏟᎭ ᏒᏙᏂᎢ.
What is she pouring it into? A glass or a bottle?	ᎦᏙ ᎤᏍᏗ ᎠᏟᏍᏗᎭ? ᎤᎸᏌᏗᏍ ᎫᎫᎨ?
I want five oil containers.	ᎯᏍᎩ ᎪᎢ ᏗᏗᎵᏍᏙᏗ ᏓᏆᏚᎵᎭ.
Don't cry.	ᏞᏍᏗ ᏣᏠᏱᎸᎢ.
Because of his old age, he barely got off his horse.	ᎠᎦᏴᎵᏴ ᎢᏳᏍᏗ, ᏎᎦᏨ ᎤᏠᎢᏒ ᏐᏈᎵᎢ.
All he does is just brag when he speaks.	ᎠᏢᏈᏍᎬᏊ ᎢᎦ ᎨᏐ ᏳᏬᏂᏌ.
Do you think you can catch up with him?	ᎡᎵᏊᏍ ᏱᏯᏢᏔ ᎮᎵ?
He makes walking canes by carving wood.	ᏗᏙᎳᏅᏍᏗ ᏕᎪᎸᏍᎪ ᎠᏓ ᏓᏲᏢᏍᎬᎢ.
Do you know anyone who is an apprentice sorcerer?	ᎯᏲᎵᎩᏍ ᎩᎶ ᎠᏙᏂᏍᎩ ᎠᏕᎶᏆᏍᎩ?
Where does one find freedom?	ᎭᏢ ᎠᏩᏛᏗ ᎠᏚᏓᎴᏍᏗ?
This German is my friend.	ᎯᎠ ᎠᏛᏥ ᎣᎦᎾᎵᎢ.
What will you be doing Saturday?	ᎦᏙ ᎭᏛᏁᎮᏍᏗ ᏙᏓᏈᏕᎾ?
He's acting silly because he wants to be laughed at.	ᎠᏥᏰᏣᏍᏙᏗ ᎤᏚᎵᎬ ᎢᏳᏍᏗ ᎠᏛᏁᎵᎭ.
The student is studying to become an actor .	ᎠᏛᏁᎵᏍᎩ ᎢᏳᎵᏍᏙᏗ ᎠᏕᏠᏆᎠ ᏗᏕᎶᏆᏍᎩ.
I'm getting ready to go somewhere. She prepares a lot of food at Christmas.	Ꮲ ᎠᏇᏅᏍᏗ ᎦᏛᏅᎢᏍᏗᎭ. ᏥᏈᏍᏗ ᎠᎵᏍᏓᏴᏗ ᎠᏛᏅᎢᏍᏗᏍᎪ ᏓᏂᏍᏓᏲᎯᎲᎢ.
When children play on the ground, they become dirty.	ᎦᏙᎯ ᏱᏚᎾᏁᎶᎿ ᏗᏂᏲᏟ, ᎠᏂᎦᏓᎭ ᎾᎾᎵᏍᏗᏍᎪᎢ.
He's always eager to help.	ᏂᎪᎯᎸ ᎠᎦᏟᏱ ᎨᏐ ᎤᏓᏍᏕᏟᏗᎢ.
The moon shines brightly if it's a full moon .	ᎤᏍᎪᏍᏗ ᎠᎦᎵᏍᎪ ᏅᏓ ᎢᏳᏃ ᎧᎵ ᏅᏓ ᏱᎩ.
The girl wants to cut her hair.He broke the string with his hands.	Ꮎ ᎠᎨᏳᏣ ᎤᏍᏘᎬ ᎤᏚᎵ. ᏧᏬᏰᏂ ᎬᏗ ᎤᎦᎳᏍᏒ ᎠᏍᏘ.
Some twisters are small and some are big .	ᎢᎠᏓ ᎠᎦᎷᎦ ᏧᏍᏗ ᎨᏐ, ᎢᎦᏓᏃ ᏧᏔᎾ.
Cows like to lick salt.	ᎠᎹ ᎤᏂᎦᎾᏗᏍᏗ ᎤᏂᎸᏉᏗ ᏩᎦ.
I was in the doctor's office.	ᎠᎦᎾᎦᏘ ᎤᏴᏍᏗ ᏫᏥᏯᎥᎢ.
He's warming his feet.	ᏧᎳᏏᏕᏂ ᏓᎦᎾᏬᏗᎭ.
When it becomes warmer, it gets warm.	ᎪᎩ ᏱᏄᎵᏍᏔᎾ ᎠᎦᎾᏬᏍᎪᎢ.
It's raining too much to go somewhere today.	ᏥᏈᏍᏗ ᎠᎦᏍᎦ ᏢᎡᏅᏍᏗ ᎪᎯ ᎢᎦ.
This man is a specially selected speaker.	ᎯᎠ ᎠᏍᎦᏯ ᎠᏎ ᎠᎦᏑᏰᏓ ᎤᏬᏂᎯᏍᏗᎢ.
Cherokees use a seine to catch crawdads.	ᎠᎦᏯᎷᏗ ᎠᏅᏗᏍᎪ ᏥᏍᏛᎾ ᏓᏂᏂᏱᏍᎬ ᎠᏂᏣᎳᎩ.
My uncle has an old squirrel dog.	ᎠᎦᏴᎵ ᏌᎶᎵ ᏧᏲ ᎩᏟ ᎤᏩᎦ ᎡᏚᏥ.
The old woman has been teaching for twenty years.	Ꮎ ᎠᎦᏴᎵᎨ ᏔᎵᏍᎪᎯ ᎾᏕᏘᏯ ᏁᎬᏕᏲᎤᎲᏍᎪᎢ.
I am going over there for a while.	ᎠᎨ ᏫᏓᎨᏙᎵ ᏞᎦ.
Who is that woman?	ᎦᎪ ᎥᏍᎩᎾ ᎠᎨᏯ?
Cherokee girls like to play ball.	ᎠᏂᏣᎳᎩ ᎠᏂᎨᏳᏣ ᎤᏂᎸᏉᏗ ᎤᎾᎳᏍᎦᏟᏗᎢ.
The Cherokees like to eat corn bread.	ᏎᎷ ᎦᏚ ᎤᏂᎩᏍᏗ ᎤᏂᎸᏉᏗ ᎠᏂᏣᎳᎩ.
When he saw money on the ground, he picked it up. Every two years he gets a new car.	ᎠᏕᎳ ᎤᎪᎭ ᎦᏙᎯ ᎠᎲ ᎤᎩᏍᏒᎢ. ᏔᎵ ᏧᏕᏘᏴᏓ ᎢᏳᏓᎵ ᎢᏤ ᏓᏆᎴᎳ ᎠᎩᏍᎪᎢ.
The Trail of Tears was agony for the Cherokee.	ᎠᏂᏣᎳᎩ ᏗᎨᏥᎢᎢᎸᏍᏔᏅ ᎠᎩᏟᏱ ᎨᏎᎢ.
He was in pain for two days.	ᏔᎵ ᏧᏒᎯᏓ ᎢᎪᎯᏓ ᎤᎩᏟᏲᏨᎢ.
My horse has a colt.	ᏐᏈᎵ ᎠᏆᏤᎵ ᎠᎩᎾ ᎤᏩᎧᎭ.
Get something to eat at the store.	ᎪᎱᏍᏗ ᎠᎩᏍᏗ ᎯᎩᏒ ᏗᏓᎾᏅᎢ.
The woman always chews gum.	Ꮎ ᎠᎨᏯ ᏂᎪᎯᎸ ᏥᎳᎵ ᎠᎩᏍᏙᏍᎪᎢ.
I see ten hens and one rooster.	ᏍᎪᎯ ᎢᏯᏂᎢ ᏥᏔᎦ ᎠᏂᎩᏏ ᏕᏥᎪᏩᏘᎭ, ᏌᏊᏅ ᎠᏨᏯ.
He's burning old papers.	ᏗᎪᏪᎵ ᏧᏪᏘ ᏓᎪᎲᏍᏗᎭ.
When the car overturned it started burning.	ᏓᏆᎴᎳ ᏚᏟᏆᏗᎾ ᎠᎪᎲᏍᎬ ᎤᏓᎴᏅᎲᎢ.
Perch are good to eat.	ᎠᏂᎪᎳ ᎠᏃᏍᏓ ᏗᎦᏰᏍᏗ.
I am reading a letter from a friend. The patient wanted a doctor to examine him.	ᎣᏂᎦᎵᎢ ᏂᏓᏳᏅᏅ ᎪᏪᎵ ᏥᎪᎴᏰᎠ. ᎠᎦᎾᎦᏘ ᎤᎪᎵᏰᏗ ᎤᏚᎵᏍᎬ ᎤᏢᎩ.
Have you gone through famine?	ᎠᎪᎾᏍ ᏣᎶᏒᎯ?
He's target practicing with a new bow.	ᎢᏤ ᎦᎵᏣᏗ ᎬᏗ ᎠᎪᏂᎭ.
Rabbits ate up her lettuce.	ᏥᏚ ᎬᏩᏒᏁᎸ ᎠᎪᏍᏓᎩᏍᏗ.
The lion ate some raw meat.	ᎠᎪᏍᏗ ᎭᏫᏯ ᎤᎬ ᏢᏓᏥ.
Don't you see it?	ᏝᏍ ᏱᎪᏩᏘ?
The green grass is really a beautiful sight.	ᎢᏤ ᎦᏄᎸᏒ ᏙᎯᏳ ᎤᏬᏚᎯ ᎠᎪᏩᏛᏗ ᎨᏐᎢ.
Your mother wants to see a picture of you.	ᏤᏣᏟᎶᏍᏔᏅ ᎤᎪᏩᏛᏗ ᎤᏚᎵ ᏣᏥ.
This boy is a Creek Indian.	ᎯᎠ ᎠᏧᏣ ᎠᎫᏌ ᎠᏴᏫᏯᎢ.
When the catcher missed catching the ball, it hit him on his forehead. 	ᎦᏂᏱᏍᎩ ᏍᏆᏞᏍᏗ ᎦᏂᏱᏍᎬ ᏚᏅᏓ ᎠᎬᏓᎨᏂ ᎤᏩᏂᎸᎢ.
She cut a pattern for a dress. She's slicing the cake with a knife.	ᎠᏌᏃ ᎤᏬᏢᏗ ᎤᎬᎭᎸᎲᎢ. ᎭᏰᎵᏍᏗ ᎬᏗ ᎠᎬᎭᎵ ᎦᏚ ᎤᎦᎾᏍᏓ.
Chop up some cabbage to cook.	ᏧᎦᏅᏕᎾ ᎬᏂᏍᏙᏗ ᎯᎬᎭᎷᏯ.
Give me a piece of cake.	ᎦᏚ ᎤᎦᎾᏍᏓ ᎠᎬᎭᎸᏓ ᏍᎬᏏ.
Is your friend a white person or black?	ᎠᏲᏁᎦᏍ ᏍᏓᎵᎢ, ᎠᎬᎿᎨᎢᎨ?
The man is scolding his son.	Ꮎ ᎠᏍᎦᏯ ᎤᏪᏥ ᎠᏧᏣ ᎠᎬᏍᎪᎸᏍᎦ.
A cat washes its face after it eats.	ᏪᏌ ᏳᎵᏍᏓᏴᏃᎿ ᎠᎬᏉᏍᎪᎢ.
Nobody likes a loudmouth.	Ꮭ ᎩᎶ ᏳᎸᏉᏗ ᎠᎭᎳᏓ. 
Flag that door down.	ᎯᎠᎷᎩ Ꮎ ᏓᏆᎴᎳ.
Let's meet here after a while.	ᎠᎭᏂ ᏙᎾᏠᏒᎢ ᎪᎯ ᏴᎢ.
Deer meat is good to eat.	ᎠᏫ ᎭᏫᏯ ᎣᏍᏓ ᎠᎩᏍᏗ.
When I closed the window, I smothered it. 	ᏦᎳᏂ ᏓᎦᏍᏚᎿ ᏥᎠᏬᏍᏔᏅᎢ.
Some snakes are not easy to see.	ᎢᎦᏓ ᎢᎾᏓ Ꮭ ᎠᎯᏓ ᏱᎩ ᏗᎪᏩᏛᏗ.
What do you have in your hand?	ᎦᏙ ᎤᏍᏗ ᎯᎯᏙᎭ.
I killed seven squirrels when I went hunting.	ᎦᎵᏉᎩ ᎢᏯᏂᎢ ᏌᎶᎵ ᏕᎦᏥᎸ ᎠᎩᏃᎭᎴᎾ.
He's driving his dad's car.	ᎤᏙᏓ ᎤᏤᎵ ᏓᏆᎴᎳ ᎠᎯᎴᎭ.
He's driving the cattle toward the pasture.	ᏠᎨᏏ ᏗᏜ ᏓᎯᎵ ᏩᎦ.
Something happened to the steering wheel.	ᎪᎱᏍᏗ ᎦᎵᏍᏓ ᎠᎯᎸᏍᏗᎢ.
Leave the car when you go back.	ᎯᎯᏴᎢ Ꮎ ᏓᏆᎴᎳ ᎢᎭᏂᎩᏒᎢ.
Put the bottle on the table.	ᎦᏍᎩᎸ ᎯᏝᎲᎦ Ꮎ ᎫᎫ.
When something scares a bird, it flies away.	ᎪᎱᏍᏗ ᏳᏍᎦᏍᏓᏁᎳ ᏥᏍᏆ, ᎠᏜᏫᏗᏍᎪᎢ.
Do you want something that flies?	ᎪᎱᏍᏗ ᎠᏝᏫᏗᏍᎩ ᏣᏚᎵ?
He likes to fly a toy airplane.	ᏥᏳ ᏗᏁᏟᏙᏗ ᎤᎸᏉᏗ ᎤᏝᏫᏘᏙᏗ.
Are you the one who flies this plane?	ᏂᎯᏍ ᎭᏝᏫᏘᏗᏍᎩ ᎯᎠ ᏥᏳ?
When he has eaten a lot, he has a nightmare. 	ᏥᏈᏍᏗ ᎤᎵᏍᏓᏴᏅ ᏱᎩ ᎠᏘᎩᏍᎪᎢ.
How long did it take for you to get a haircut?	ᎯᎠ ᎢᎪᎯᏓ ᎤᏟᎢᎵᏙᎴ ᎡᏣᏙᏰᏍᎬ?
A carpenter uses a ruler in measuring the place where he cuts the board.	ᏗᏁᏍᎨᏍᎩ ᎠᏟᎶᏍᏗ ᎬᏗᏍᎪ ᎠᏟᎶᏍᎬ ᎢᏴ ᎤᏍᏆᎵᏍᏗ ᏯᏖᎾ.
Hand me a ruler.	ᎠᏟᎶᏍᏗ ᎡᏍᎩᏗᏏ
When he hit the steel post with a car, it bent.	ᏓᏆᎴᎳ ᎬᏗ ᎤᏩᏂᎳ ᏔᎷᎩᏍᎩ ᎨᏛ, ᎤᏟᏴᏈᏛᏅᎢ.
When a deer is trying to scare something, it snorts .	ᎪᎱᏍᏗ ᏯᏍᎦᏍᏓᏁᎭ ᎠᏫ, ᎠᏟᏴᏌᎾᏩᏗᏍᎪᎢ.
He preached for one hour .	ᏑᏟᎶᏓ ᎢᎪᎯᏓ ᎤᎵᏣᏙᏅᎢ
Three of his sons became preachers.	ᏦᎢ ᎢᏯᏂ ᏧᏪᏥ ᎠᏂᏧᏣ ᎠᎾᎵᏣᏙᎲᏍᎩ ᏄᎾᎵᏍᏔᏅᎢ.
When the ball hit the window, it shattered.	ᏍᏆᏞᏍᏗ ᎤᏩᏂᎳ ᏦᎳᏂ, ᎤᎵᎪᏛᏅᎢ.
He shatters the bottles by shooting them.	ᏓᏲᎯᎲ ᏓᎵᎪᏛᏗᏍᎪ ᎫᎫ.
I like to play records.	ᏗᏠᏗ ᏗᏆᏁᏟᏙᏗ ᎠᎩᎸᏉᏗ.
When we played ball by ourselves, I beat him.	ᎣᎩᏅᏌ ᎣᎩᎾᎳᏍᎦᎸᎭ, ᏥᏠᏒᎢ.
She combs her hair all the time, and that's why she has pretty hair.	ᏂᎪᎯᎸ ᎠᎵᏔᏬᏍᎪ, ᎤᏍᎩᏅ ᎢᏳᏍᏗ ᎤᏬᏚᎯ ᏧᏍᏘᎦ.
I want to buy a comb	ᎠᎵᏔᏬᏍᏗ ᎠᎩᏩᎯᏍᏗ ᎠᏆᏚᎵ.
The snake isn't dead . It's still moving.	Ꮭ ᎤᎵᏬᏨ ᏱᎩ Ꮎ ᎢᎾᏓ. Ꮟ ᎠᎵᏖᎸᎲᏍᎦᏊ.
When his shirt got dirty, he changed it.	ᎦᏓᎭ ᏄᎵᏍᏔᎾ ᎤᎿᎠᏬ, ᎤᎿᏩᎢᏴᏒᎢ.
When it got warm, he took off his coat.	ᎤᎦᎾᏬᏌ, ᎤᎿᏪᏒ ᎦᏌᎴᏂ
I have a shirt made of cowhide.	ᏩᎦ ᎨᎦ ᎪᏢᏔᏅ ᎠᎿᏬ ᎠᎩᎾᎠ.
She was given a new coat, but she didn't wear it.	ᎢᏤ ᎦᏌᎴᏂ ᎠᏥᏅᏁᎸ ᎠᏎᏅ Ꮭ ᏳᎿᏬᎡᎢ.
He gave his son ten dollars.	ᏍᎪᎯ ᎠᏕᎸ ᎤᏁᎸ ᎤᏪᏥ ᎠᏧᏣ.
Indians like to wrestle.	ᎠᏂᏴᏫᏯ ᎤᏂᎸᏉᏗ ᎤᎾᏁᏍᏗ
He's interpreting the speaker's speech.	ᎦᏬᏂᏍᎩ ᎦᏬᏂᏍᎬ ᎠᏁᏟᏗᎭ.
I want a translation of this book.	ᎯᎠ ᎪᏪᎵ ᎠᏁᏟᏔᏅ ᎠᏆᏚᎵᎭ
The children are frolicking in the grass	ᎦᏄᎸᎯ ᎠᎾᏁᏦᏍᎦ ᏗᏂᏲᏟ.
The carpenter built a big chicken house.	Ꮎ ᏗᏁᏍᎨᏍᎩ ᎤᏔᎾ ᏥᏔᎦ ᎤᏂᏴᏍᏗ ᎤᏁᏍᎨᎲᎢ.
He left yesterday morning. When he put a new battery in the car, it started up easily.	ᏒᎯ ᏑᎾᎴ ᏥᎨᏒ ᏧᏂᎩᏒᎢ. ᎢᏤ ᎠᎾᎦᎵᏍᎩ ᎤᏝᎾ, ᎠᎯᏓ ᎤᏂᎩᏒ ᏓᏆᎴᎳ.
He wants to start the car but he doesn't have the keys.	ᏓᏆᎴᎳ ᎤᏂᎩᏍᏙᏗ ᎤᏚᎵ, ᎠᏎᏅ Ꮭ ᏗᏍᏚᎢᏍᏗ ᏱᏚᏩᏯ.
He carried three posts on his shoulder.	ᏦᎢᎭ ᏗᎨᏛᏍᏗ ᏚᏃᏟᏅᏒᎢ.
He burned his mouth drinking hot soup.	ᎠᎰᎵ ᎤᎴᏴᏒ ᎤᏗᏞᎩ ᎤᎦᎹ ᎠᏥᏔᏍᎬᎢ.
She's putting some corn in the boiling water.	ᎠᎹ ᎠᎵᏟᏍᎬ ᏓᎱᏗᎠ ᏎᎷ.
Where can I find some stove pipes?	ᎭᏢ ᏱᏕᏥᏴᏩᏔ ᎣᏏ ᏗᎱᏣᏬᎳᏛᏗ?
If you will look just a little to the left, you will see a chimney.	ᏍᏗᎩᏓᏊ ᎠᎦᏍᎦᎾᎢ ᏗᏜ ᏳᏗᏣᎧᎿᎾ, ᏳᏫᎪᏩᏔ ᎠᎱᏣᏬᎳᏛᎢ.
Indians use a drum when they chant.	ᎠᏂᏴᏫᏯ ᎠᎾᏴᎴᎬ ᎠᎱᎵ ᎠᏅᏗᏍᎪᎢ.
He wanted to hit him on the mouth, but he got scared.	ᎤᎱᎸᏂᏍᏗ ᎤᏚᎵᏍᎬ, ᎠᏎᏅ ᎤᏍᎦᎸᎢ.
Move the car. It's in the way.	ᎯᎲᎾ ᏓᏆᎴᎳ. ᎢᎬᏱ ᏗᏜ ᎠᎭ.
Set the groceries down.	ᎡᎳᏗ ᎯᎲᎦ ᎠᎵᏍᏓᏴᏗ
When something is hidden from him, he finds it easily	ᎪᎱᏍᏗ ᏯᎬᏍᎦᎳᏁᎳ, ᎠᎯᏓ ᎠᏩᏘᏍᎪᎢ.
Who do you want to visit?	ᎦᎪ ᎯᏩᏛᎯᏓᏍᏗ ᏣᏚᎵ?
He took the ball home with him.	ᏧᏪᏅᏒ ᎤᏫᏛᎲ ᏍᏆᏞᏍᏗ.
She planted flowers near the building.	ᎠᏂᏥᎸᏍᎩ ᏚᏫᏒ ᎠᏓᏁᎸ ᎾᎥᎢ.
Do you want to buy a necktie?	ᎠᏯᏢᏗᏍ ᏣᏩᎯᏍᏗ ᏣᏚᎵ?
Peel some potatoes.	ᏄᎾ ᏘᏯᎨᏗᏌ.
She received a pretty necklace for her birthday.	ᎤᏬᏚᎯ ᎠᏯᏟᏗ ᎤᎩᏒ ᎤᏕᏘᏱᏍᎬᎢ.
Did it frost last night?	ᎤᏯᏛᏁᎢᏍ ᎤᏒ ᏥᎨᏒ?
He's calling the dog with a cow horn. Where did you get this dog?	ᏩᎦ ᎤᏲᏂ ᎬᏗ ᎠᏯᏂᎭ ᎩᏟ. ᎭᏢ ᎯᏯᏅᎮ ᎯᎠ ᎩᏟ?
Where are you taking the ball?	ᎭᏢ ᎯᏰᎦ ᏍᏆᏞᏍᏗ?
He had ten dollars worth of pennies in his hand.	ᏍᎪᎯ ᎠᏕᎸ ᏧᎬᏩᏟᏗ ᏌᏊ ᎢᏯᎾᏓᏅᏞᏗ ᏓᏰᎲᎢ.
She quilted it with white cotton.	ᎤᏁᎦ ᎤᏥᎸ ᎬᏗ ᎤᏰᎦᏝᏅᎢ.
The surgeon is operating on the patient.	ᏗᏓᏰᏠᎯ ᎤᏢᎩ ᎠᏰᏠᎭ.
He imitates birds with his whistling. Who are you mocking?	ᏥᏍᏆ ᏓᏰᎵᏍᎪ ᎦᏒᎬᎢ. ᎦᎪ ᎯᏰᎵᎠ?
I lost my knife while hunting.	ᏥᏃᎠᎵᏙᎲ ᎠᎩᎰᎱᏎᎸ ᎭᏰᎵᏍᏗ
I'm looking for my friend. Where did he go?	ᎣᎩᎾᎵᎢ ᏥᏲᎭ. ᎭᏢ ᏫᎦᎶᎯ?
How far can you swim?	ᎯᎳ ᎢᏳᏓᏅᎯᏓ ᎡᎵᏊ ᏯᎱᎢᏄᎦ?
Do you hear it thundering?	ᎭᏛᎩᎠᏍ ᎠᏴᏓᏆᎶᏍᎬ?
Are you afraid of thunder?	ᎯᏍᎦᎰᎢᏍ ᎠᏴᏓᏆᎶᏍᎩ?
He wants to buy an air conditioner in the summer.	ᎠᏴᏜᏗᏍᏗᏍᎩ ᎤᏩᎯᏍᏗ ᎤᏚᎵ ᎪᎩ ᎢᏴᎢ.
He made a six-foot ladder.	ᏑᏓᎵ ᎢᎳᏏᏗ ᎢᎦᏅᎯᏓ ᎠᏴᏠ ᎤᏬᏢᏅᎢ
Don't bend it! When I finish sewing the quilt, I am going to hem it.	ᏞᏍᏗ ᏥᎯᏴᏈᏛᏂ! ᏥᏍᏆᏛ ᏥᏰᏫᏍᎬ ᏰᎦᏟ, ᏓᏥᏴᏈᏛᏂ.
I was going to shoot a rabbit in his throat but I missed.	ᎠᏴᏤᏂ ᏓᏥᏲᎵᏒ ᏥᏍᏚ ᎠᏎᏅ ᏕᎢᏅᏛᎢ.
He tried to kick above his head.	ᎠᏍᎪᎵ ᎦᎸᎳᏗᏜ ᎤᏴᏖᏍᏗ ᎤᏁᏟᏔᏅᎢ.
Some soldiers have become prisoners.	ᎢᎦᏓ ᎠᏂᏲᏍᎩ ᎠᏂᏴᎩ ᏄᎾᎵᏍᏔᎾ.
The soldier captured his enemy.	ᏗᏂᏓᎿᏫ ᎤᏴᎩᏛ ᎠᏲᏍᎩ.
Who hit him on the nose?	ᎦᎪ ᎤᏴᏍᏕᎷᏁᎢ.
The shirt collar is choking him.	ᎠᎿᏬ ᎦᏯᏢ ᎤᏴᏍᎩᏱᎭ.
Someone is walking toward the building.	ᏗᏓᏁᎸ ᏗᏜ ᏩᎢ ᎩᎶ.
How many fish did you catch?	ᎯᎳ ᎢᏯᏂᎢ ᎠᏣᏗ ᏕᎯᏂᏴᎮ?
Is that man a Choctaw or Cherokee?	ᎠᏣᏓᏍ Ꮎ ᎠᏍᎦᏯ, ᎠᏣᎳᎩᎨ?
How many chicks hatched?	ᎯᎳ ᎢᏯᏂ ᏥᏔᎦ ᎠᏂᏓ ᎤᎾᏣᎢᏎᎢ?
When he goes to the city, he dresses up.	ᎤᏔᎾ ᏗᎦᏚᎲ ᏳᏪᎾ ᎠᏣᏅᏍᎪᎢ.
Get in the car	ᏓᏆᎴᎷ ᎭᏣᎥᎦ.
He is acting like an Indian.	ᎠᏴᏫᏯ ᎠᏤᎸᏍᎦ.
The boys are wrestling on the mattress.	ᎠᏤᏍᏙ ᎦᎾᎥ ᎠᎾᏁᎯᎲ ᎠᏂᏧᏣ.
He's spilling water on the ground.When he' s got a lot of money, he just wastes it.	ᎦᏙᎯ ᎠᏤᏫᎠ ᎠᎹ. ᏥᏈᏍᏗ ᎠᏕᎳ ᏱᏚᎭ, ᏓᏤᏫᏍᎪᎢᏊ.
At the stomp dance grounds they dance around the fire.	ᎠᏥᎳ ᎠᎲ ᎠᎾᏕᏲᎰ ᎠᎾᎵᏍᎩᏍᎬ ᎦᏘᏲᎢ.
Let's go look for some watercress.	ᎠᎹᏱ ᎡᎯ ᎠᏥᎳ ᎢᎩᏯᎷᎦ.
A Catholic spoke at the meeting.	ᎠᏥᎳ ᎨᏠᎯ ᎤᏬᏂᏒ ᏓᎾᏠᏍᎬᎢ
Give me a match.	ᎠᏥᎳ ᎪᏢᏗ ᏍᎩᏗᏏ.
He threw coal into the fire.	ᎠᏥᎸᎯ ᏭᏗᏅᏒ ᏥᏃᏍᎦ.
Flowers bloom in the spring.	ᎪᎨᏱ ᎠᏂᏥᎸᏍᎪ ᎠᏂᏥᎸᏍᎩ.
Someone gave her some flowers.	ᎠᏂᏥᎸᏍᎩ ᏚᏅᏏ ᎩᎶᎢ
A cedar is always green	ᎠᏥᎾ ᏂᎪᎯᎸ ᎢᏤ ᎨᏐᎢ
He lit the cigarette with a match.	ᎠᏥᎳ ᎪᏢᏗ ᎬᏗ ᎤᏥᎳᏅᎢ ᎪᎩᏍᏗ
He's blowing on the hot coffee.	ᎧᏫ ᎤᏗᎴᎩ ᎠᏦᏔᏍᎦ.
Turn on the lights at six o'clock in the morning	ᏑᏓᎵ ᎢᏳᏩᏂᎸ ᏑᎾᎴ ᏕᎯᏨᏍᏔᏅᎢ.
When lightning flashed, the electric lights went out.	ᎤᎾᎦᎸᎭ, ᎠᎾᎦᎵᏍᎩ ᏗᏨᏍᏗ ᏚᏠᏒᎢ.
-----	-----
The policeman was given a badge.	ᎠᎧᏁᏍᏗ ᎠᏥᏁᎸ ᏗᏓᏂᎢᏍᎦ.
He hurt his hip when he fell.	ᎠᎧᏍᎨᏂ ᎤᏪᎯᏍᏓᏁᎸ ᎤᏅᏣ.
When the dog sees cows, he chases them.	ᏩᎦ ᏱᏚᎪᎭ ᎩᏟ, ᏓᎨᎮᎪᎢ.
Where are the stairs?	ᎭᏢ ᎢᏴ ᎪᎸ ᎠᎩᏠᏒᏍᏗᎢ?
He likes to ride a bicycle.	ᏔᎵ ᏗᎦᏆᏘ ᎤᎩᎸᏙᏗ ᎤᎸᏉᏗ
The doctor gave the patient some pills.	ᎠᎦᎾᎩᏘ ᏗᎩᏍᏗ ᏚᏁᎸ ᎤᏢᎩ.
I am barely swallowing because my throat hurts.	ᏤᏴᏤᏂ ᎠᏇᎯᏍᏓᏁᎲ ᎢᏳᏍᏗ ᏎᎦᏨ ᏥᎩᏍᎦ.
I saw an elbow through an opening in the door.	ᎠᎩᏳᏍᎨ ᎠᎩᎪᎲ ᎦᎶᎯᏍᏗ ᏭᏜᏅᏛᎢ.
His elbows got dirty when he crawled.	ᏗᎩᏳᏍᎨᏂ ᏗᎦᏓᎭ ᏂᏚᎵᏍᏔᏅ ᎤᏓᎾᏏᏅᏌ.
She's shoveling a place to set out flowers.	ᎠᏂᏥᎸᏍᎩ ᏧᏩᎪᏗ ᎠᎪᏕᎠ.
He's making a handle for a shovel.	ᎠᎪᏕᏍᏗ ᎫᎭᏟᏗ ᎪᏢᏍᎦ.
He turned right but the others turned left.	ᎠᎦᏘᏏ ᏗᏜ ᏭᏞᏒ ᎠᏂᏐᎢᏃ ᎠᎦᏍᎦᏂ ᏗᏜ ᏭᎾᏞᏒᎢ.
This ball player is left-handed.	ᎯᎠ ᎠᎳᏍᎦᎵᏍᎩ ᎠᎦᏍᎦᏂᏓ.
He goes down a long hill when he goes after water.	ᎦᏅᎯᏓ ᎠᎦᏐᏍᎬ ᎠᎦᏍᎪ ᎠᎹ ᏳᏁᎩᏎᎾ.
He pushed the car down-hill.	ᎠᎦᏐᏍᎬ ᏭᏩᏌᏙᏴ ᏓᏆᎴᎳ.
He has one artificial eye.	ᎠᎦᏔ ᎠᏰᎸᎯ ᎠᎧᎿ ᏌᏊᎢ.
Do you know how to speak Cherokee?	ᎯᎦᏔᎭᏍ ᏣᎳᎩ ᏣᏬᏂᎯᏍᏗ?
Who is a witness to what happened?	ᎦᎪ ᎠᎦᏔᎯ ᏄᎵᏍᏔᏂᏙᎸᎢ
This man is very knowledgeable.	ᎯᎠ ᎠᏍᎦᏯ ᎤᏙᎯᏳ ᎠᎦᏔᎿᎢ.
When he heard someone calling him, he turned around. He wanted to turn back before he got there.	ᎩᎶ ᎤᏯᏂᏍᎬ ᎤᏛᎦᎾ ᎤᎦᏔᎲᏒᎢ. ᏫᏄᎷᏨᎾᏊ ᎤᎦᏔᎲᏍᏗ ᎤᏚᎸᎲᎢ.
The boy is winking at the girl.	Ꮎ ᎠᏧᏣ ᎠᎨᏳᏣ ᎠᎦᏔᏍᏓᏁᎭ.
He hit the boy in the eye with a rock	ᏅᏯ ᎬᏗ ᎤᎦᏖᎷᏅ ᎠᏧᏣ.
The scenery is pretty in the spring.	ᎤᏬᏚᎯ ᎨᏐ ᎠᎦᏖᎾᏍᏗ ᎪᎨᏱ.
I don't want anything. I'm just looking around.	Ꮭ ᎪᎱᏍᏗ ᏯᏆᏚᎵ. ᏥᎦᏖᏃᎵᏙᎭᏊ.
Someone is peeking through the window.	ᏦᎳᏂ ᎠᎦᏘᎭ ᎩᎶᎢ.
He throws a ball with his right hand.	ᎠᎦᏘᏏ ᎬᏗ ᎤᏕᎪ ᏍᏆᏞᏍᏗ.
Wait for me. I'll be right back.	ᏍᎩᎦᏘᏰᏍᏗ. ᎩᎳᏊ ᏛᏥᎷᏥ.
He was chosen to be a guard at the bank.	ᎠᏕᎳ ᏗᏗ ᎠᎦᏘᏱ ᎠᎦᏑᏰᏒᎢ.
He wants a telescope for his birthday.	ᎠᎦᏙᏗ ᎤᏚᎵ ᎤᏕᏘᏱᏍᎬᎢ.
He became wise when he was just a boy.	ᎠᏧᏣᏊ ᏥᎨᏒ ᎤᎦᏙᎥᏒᎢ.
His right eye is always bothering him.	ᎠᎦᏘᏏ ᎠᎦᏙᎵ ᏂᎪᎯᎸ ᎤᏕᏯᏙᏗᏍᎪᎢ.
Do you like to watch television?	ᏣᎸᏉᏗᏍ ᎠᏓᏴᎳᏛᏍᎩ ᎭᎦᏙᏍᏙᏗ?
Some Cherokees have wisdom.	ᎢᎦᏓ ᎠᏂᏣᎳᎩ ᎠᎦᏙᎥᎯᏍᏗ ᎤᏂᎭ.
He barely went through the small opening.	ᏎᎦᏨ ᎤᎦᏛᎴᏒ ᎤᏍᏗ ᎤᏜᏅᏛᎢ.
She's dipping water from a bucket.	ᏒᏙᏂ ᎠᎫᎩᎠ ᎠᎹ.
Where is the dipper? I'm thirsty (for water)	ᎭᏢ ᎠᎫᎩᏍᏗ? ᎠᎹ ᎠᎩᏔᏕᎩᎠ.
I'm paying sixty dollars a month for my car.	ᏑᏓᎵᏍᎪ ᎠᏕᎸ ᎦᏈᏱᎭ ᏓᏆᎴᎳ ᏏᏅᏓ.
How much did you pay him?	ᎯᎳ ᎢᎦ ᎯᏯᏈᏴᎡᎴ?
Cherokees like feather pillows.	ᏧᎩᏓᏟ ᏗᎦᏅᏗ ᏗᏈᏍᏙ ᏚᏂᎸᏉᏗ ᎠᏂᏣᎳᎩ.
He killed the snake by tromping on it. He always speaks badly of people.	ᎠᎳᏍᏓᎡᏍᎬ ᎤᏢ ᎢᎾᏓ. ᏂᎪᎯᎸ ᏴᏫ ᏓᎳᏍᏓᎡᏍᎪᎢ.
There's a bug crawling. Step on it!	ᏥᎪᏯ ᎠᏓᏏᏂ. ᎯᏯᎳᏍᏛᎥᎦ!
He didn't play ball because his hand was hurting.	ᎤᏬᏰᏁ ᎤᏪᎯᏍᏓᏁᎲ ᎢᏳᏍᏗ Ꮭ ᏳᎳᏍᎦᎸᎮᎢ.
The ball players practice every day.	ᏧᏙᏓᏋᏓ ᎠᎾᎵᏏᎾᎲᏍᏗᏍᎪ ᎠᎾᎳᏍᎦᎵᏍᎩ.
A crippled man takes a step carefully.	ᎠᏲᎤᏟ ᎠᏍᎦᏯ ᎤᎦᏎᏍᏗ ᎠᎳᏍᎬᏍᎪᎢ.
The lawyer began working on a law suit.	ᎠᎳᏑᏟᏗ ᏚᎸᏫᏍᏓᏁᎲ ᎤᎴᏅᎲ ᏗᏘᏲᎯᎯ
He forgot to polish the shoes.	ᏗᎳᏑᎶ ᏧᎶᏁᏗ ᎤᏩᎨᏩ.
As I walked along the grass, I almost stepped on a snake.	ᎦᏄᎸᎯ ᎦᎢᏒ ᎠᎴ ᎢᎾᏓ ᏂᏥᏯᎳᏍᏛᏔᏅᎢ.
I see men and women. If you want to go or not, that's just fine.	ᎠᏂᏍᎦᏯ ᎠᎴ ᎠᏂᎨᏯ ᎦᏥᎪᏩᏘᎭ. ᏤᏅᏍᏗ ᏱᏣᏚᎵ, ᎠᎴ Ꮭ ᏱᎩ ᎣᏏᏊ.
He tried to stand a heavy piece of steel in an upright position.	ᏔᎷᎩᏍᎩ ᎦᎨᏓ ᎤᎴᏙᏗ ᎤᏁᏟᏔᏅᎢ.
Stand here in the middle.	ᎠᎭᏂ ᎠᏰᎵ ᎭᎴᎲᎦ.
When he heard someone calling him, he stopped.	ᎩᎶ ᎤᏯᏂᏍᎬ ᎤᏛᎦᎾ, ᎤᎴᏫᏍᏔᏅᎢ.
`	ᎭᎴᏫᏍᏙᏓ ᏓᏆᎴᎳ.
When can you start working?	ᎯᎳᏴ ᎡᎵᏊ ᏯᎴᎾ ᏕᏣᎸᏫᏍᏓᏁᎲ?
The coffee is boiling.	ᎧᏫ ᎠᎵᏟᎭ.
His shirt was soaked with sweat.	ᎠᎵ ᏚᏖᎡᏒ ᎤᏄᏮᎢ.
The Indian with the long hair wants a headband.	Ꮎ ᎦᏅᎯᏓ ᎤᏍᏘᎩ ᏥᎩ ᎠᏴᏫᏯ ᎠᎵᎬᏓᏃᏍᏙᏗ ᎤᏚᎵᎭ.
Firemen use protective masks.	ᏗᏅᏜᏗᏍᎩ ᏗᎵᏍᏕᎸᏙᏗ ᏗᎵᎬᏚᎶ ᏓᎾᏗᏍᎪᎢ.
When his son helps him work, he thanks him.	ᎤᏪᏤ ᎠᏧᏣ ᏳᏍᏕᎸᎭ ᏚᎸᏫᏍᏓᏁᎲ, ᎠᎵᎮᎵᏤᎰᎢ.
For what reason is he happy?	ᎦᏙ ᎤᏰᏟᏗ ᎠᎵᎮᎵᎦ?
Friendship is important in the lives of people.	ᎠᎵᎢ ᎤᎵᏍᎨᏓ ᏴᏫ ᎠᏁᎲᎢ.
Let's trade knives.	ᎢᎾᎵᎢᏓ ᎭᏰᎵᏍᏗ.
I caught a rabbit yesterday, but it ran away from me. He escaped from jail.	ᏥᏍᏚ ᏥᏂᏴᎲᎢ ᏒᎯ ᎠᏎᏅ ᎠᏆᎵᏘᎡᎸᎢ. ᏧᎾᏓᏍᏚᏗ ᎠᏯᎥ ᎤᎵᏘᏒᎢ.
I lost some gloves.	ᏗᎵᏰᏑᎶ ᏓᎩᏲᎱᏏ.
When he goes swimming, he takes his ring off.	ᏳᏓᏬᎡᎾ ᎠᎵᏰᏑᏍᏘᎩᏍᎪᎢ.
I am making a big ring.	ᎤᏔᎾ ᎠᎵᏰᏑᏍᏙ ᎪᎸᏍᎦ.
She has a three hundred dollar ring on her finger.	ᏦᎢᏥᏆ ᎠᏕᎸ ᏧᎬᏩᎵᏗ ᎠᎵᏰᏑᏍᏙ ᎤᎵᏰᏑᏍᏘᎦ.
He has on red socks.	ᏗᎩᎦᎨ ᏗᎵᏲ ᏚᎵᏲᎭ.
Don't go around spitting.	ᏞᏍᏗ ᏯᎵᏥᏈᏙᎮᏍᏗ.
Raise up awhile.	ᎭᎵᏌᎳᏛᎦ ᏞᎦ.
She wants to shop for groceries.	ᎠᎵᏍᏓᏴᏗ ᎤᏓᎾᏁᏒᎲᏍᏗ ᎤᏚᎵᎭ.
In the evening, he eats a big meal.	ᏒᎯᏰᏱ ᎤᏔᎾ ᎠᎵᏍᏓᏴᎲᏍᎪᎢ.
The student asked for assistance.	ᎠᎵᏍᏕᎸᏙᏗ ᎤᏔᏲᎲ ᏗᏕᎶᏆᏍᎩ.
He helps in the building of houses.	ᎦᎵᏦᏕ ᏓᎾᏁᏍᎨᏍᎬ ᎠᎵᏍᏕᎵᏍᎪᎢ.
When he entered the house, he took off his cap.	ᎦᎵᏦᏕ ᎤᏴᏝ ᎤᎵᏍᏚᎴᏒᎢ.
How long does it take when she washes her hair?	ᎯᎳ ᎢᎪᎯᏓ ᎠᎯᎵᏙᎰ ᏳᎵᏍᏚᎴᎭ?
Put on a cap when you go out because it's cold outside.	ᎭᎵᏍᏚᎳᏅ ᎯᏄᎪᏨᎢ, ᎤᎲᏜᎮᏃ ᏙᏱ.
Where did you get this cap? 	ᎭᏢ ᏣᏁᏎ ᎯᎠ ᎠᎵᏍᏚᎶ?
He sat down close to where the speaker was standing.	ᎦᏬᏂᏍᎩ ᎦᏙᎬ ᎾᎥ ᎤᎵᏍᏛᏡᏅᎢ.
When something hit him in the eye, he shook his head.	ᎪᎱᏍᏗ ᎤᏩᏂᎳ ᎠᎦᏙᎵ, ᎤᎵᏍᏛᏂᎸᎢ.
Some Cherokee girls like to dance. 	ᎢᎦᏓ ᎠᏂᏣᎳᎩ ᎠᏂᎨᏳᏣ ᎤᏂᎸᏉᏗ ᎤᎾᎵᏍᎩᏍᏗᎢ. 
Permit me to speak.	ᏍᏆᎵᏍᎪᎸᏓᏏ ᎠᎩᏬᏂᎮᏍᏗᎢ.
Nod your head if you accept.	ᎭᎵᏍᎫᏯ ᏕᎭᏓᏂᎸᎨᏍᏗ.
I had just arrived when their speeches ended.	ᎩᎳ ᎠᎩᎷᏨ ᎤᎵᏍᏆᏛ ᏓᏂᏬᏂᏍᎬᎢ.
A little boy is sticking his head out the window.	ᏦᎳᏂ ᎤᎵᏍᏆᎷᏓ ᎤᏍᏗ ᎠᏧᏣ.
Take your hat off. Let me look at it.	ᎭᎵᏍᏇᏚᎩ. ᏥᎪᎵᏯ.
When he goes to town, he puts on clean clothes and a good hat.	ᏗᎦᏚᎲ ᏳᏪᎾ ᏧᏓᏅᎦᎸᏓ ᏓᎿᏬᏍᎪᎢ ᎣᏍᏓᏃ ᎠᎵᏍᏇᏚᏬ ᎠᎵᏍᏇᏚᎲᏍᎪᎢ. 
How much did you pay for the hat?	ᎯᎳ ᎢᎦ ᏣᏈᏴᎮ Ꮎ ᎠᎵᏇᏚᏬ?
What is he aiming to do?	ᎦᏙ ᎤᏛᏁᏗ ᎠᎵᏐᏍᏗᎭ?
She likes to smell flowers.	ᎠᏂᏥᎸᏍᎩ ᏧᎵᏒᏍᏙᏗ ᎤᎸᏉᏗ.
We get our drinking water from a spring.	ᎦᏄᎪᎬ ᎣᏥᏁᎩᏍᎪ ᎠᎹ ᎣᎦᏗᏔᏍᏗ.
Get some salt when you go to town.	ᎠᎹ ᎯᎩᏒ ᏗᎦᏚᎲ ᏪᏙᎸᎢ.
Who dug this water well?	ᎦᎪ ᎤᏍᎪᏎᎢ ᎯᎠ ᎠᎹᏢᏗᎢ?
Fill the water bucket.	ᎠᎹᏢᏙᏗ ᎯᎧᎵᏣ.
My home is in the United States. 	ᎠᎹᏰᏟ ᏗᏇᏅᏒ ᎠᏴ.
Jump into the water. 	ᎠᎹᏱ ᏫᏔᎵᏔᏚᎦ.
I found these shoes by the shore.	ᎠᎹᏳᏟᏗ ᏓᎩᎾᏩᏛᎲ ᎯᎠ ᏗᎳᏑᎶ.
The fish in the ocean are big.	ᎠᎺᏉ ᎠᏁᎯ ᎠᏣᏗ ᏧᎾᏔᎾ ᎨᏐᎢ.
She entered a beauty contest.	ᏧᏃᏚᎯ ᎠᎾᏓᎪᎾᏘᏗᏍᎬ ᎤᏖᎳᏛᎢ.
A lot of people are gathering in town today.	ᏥᏈᏍᏗ ᏴᏫ ᎠᎾᏓᏟᏏᎭ ᏗᎦᏚᎲ ᎪᎯ ᎢᎦ.
It's lightening too much to play outside.	ᏥᏈᏍᏗ ᎠᎾᎦᎵᎭ ᏙᏱ ᏗᏁᎶᏗᎢ.
The dead battery couldn't start the car	ᎤᎵᏬᏨ ᎠᎾᎦᎵᏍᎩ ᎤᏄᎸᏅ ᎤᏂᎩᏍᏙᏗ ᏓᏆᎴᎳ.
These five boys are all brothers.	ᎯᎠ ᎯᏍᎩ ᎢᏯᏂᎢ ᎠᏂᏧᏣ ᏂᎦᏓ ᎠᎾᏟᏅᏟ.
This boy and girl want to go together.	ᎯᎠ ᎠᎨᏳᏣ ᎠᏧᏣᏃ ᎤᎾᎵᎪᏗ ᎤᎾᏚᎵᎭ.
Little girls play with dolls.	ᏧᎾᏍᏗ ᎠᏂᎨᏳᏣ ᏗᏁᏟᏗ ᏓᎾᏁᏟᏗᏍᎪᎢ.
He's trying to start the car.	ᏓᏆᎴᎳ ᎤᏁᎩᏍᏙᏗ ᎠᏁᏟᏗᎭ.
My friend got married as soon as he turned eighteen.	ᏁᎳᏚᏊ ᏄᏕᏘᏴᎭ ᎤᏁᎳᏛᎢ ᎣᎩᎾᎵᎢ.
Do you remember what I said long ago?	ᎭᏅᏓᏗᎠᏍ ᎾᎩᏪᏒ ᎪᎯᎩᏴ ᏥᎨᏒ?
They grow a lot of strawberries in Stilwell.	ᏥᏈᏍᏗ ᎠᏂ ᎠᎾᏛᎯᏍᏗᏍᎪ ᏍᏗᎳᏪᎵ.
They were standing for two hours.	ᏔᎵ ᎢᏳᏟᎶᏓ ᎢᎪᎯᏓ ᎠᏂᏙᎾᎥᎢ.
At eleven o'clock last night, they were already asleep.	ᏌᏚ ᎢᏳᏩᏂᎸ ᎤᏒ ᎦᏳᎳ ᎠᏂᏟᏅᎢ.
They sat quietly.	ᎡᏝᏪ ᎠᏂᏅᎢ.
Her husband teaches at school.	ᏧᎾᏕᏠᏆᏍᏗ ᏓᏕᏲᎲᏍᎪ ᎠᏂᏁᎵ.
I'm going to Mexico in the summer.	ᎠᏂᏍᏆᏂ ᏓᎨᏏ ᎪᎩ ᎢᏴᎢ.
I was in the military service for three years.	ᏦᎢ ᏧᏕᏘᏴᏓ ᎠᎩᏴᏢ ᎠᏂᏲᏍᎩᎢ.
My mother's birthday is May fifth.	ᎠᏂᏍᎬᏘ ᎯᏍᎩᏁ ᎤᏕᏘᏱᏍᎩ ᎡᏥ.
Spring begins in the month of March.	ᎠᏅᏱ ᎧᎸ ᎠᏓᎴᏂᏍᎪ ᎪᎨᏱ.
He set a trap for a raccoon but he didn't catch it.	ᎬᏟ ᎤᏌᏛᏅ ᎠᏎᏅ Ꮭ ᏳᏁᏴᎮᎢ.
Raise the window.	ᏦᎳᏂ ᎯᏌᎳᏛᎦ.
Who is smarter, you or your sister?	ᎦᎪ ᎤᎪᏗ ᎠᏌᎹᏗᏯ, ᏂᎯ ᎡᏣᏙᎨ?
I want a new dress. 	ᎢᏤ ᎠᏌᏃ ᎠᏆᏚᎵ.
She's starching her husband's shirts.	ᎠᏂᏁᎵ ᏧᎿᏬ ᏓᏍᏓᎦᏴᏗᎭ.
When he put the snake skin out in the sunshine, it became crisp.	ᎠᎦᎵᏍᎬ ᏭᏅᎾ ᎢᎾᏓ ᎦᏁᎦ ᎤᏍᏓᎦᏴᏢᎢ.
Follow these lines. 	ᎯᎠ ᏓᏍᏓᏅᏅ ᏘᏍᏓᏩᏚᎦ.
He drew a line with a red pencil.	ᎩᎦᎨ ᏗᎪᏪᎶᏗ ᎬᏗ ᎤᏍᏓᏅᎿᏅᎢ. 
The little boy is following his father.	Ꮎ ᎤᏍᏗ ᎠᏧᏣ ᎤᏙᏓ ᎠᏍᏓᏩᏕᎦ.
I am helping him build a house.	ᎦᎵᏦᏕ ᎠᏁᏍᎨᏍᎬ ᏥᏍᏕᎵᎭ.
The girl is braiding her hair.	ᎤᏍᏘᎬ ᎠᏍᏕᏲ ᎠᎨᏳᏣ.
He wants to eat a cucumber.	ᎦᎦᎹ ᎤᏍᏗᎩᏍᏗ ᎤᏚᎵᎭ.
A pencil is not something to eat.	ᏗᎪᏪᎶᏗ Ꮭ ᎠᏍᏗᎩᏍᏗ ᏱᎩ.
Do you want him to crush some rocks?	ᏅᏯᏍ ᎤᏍᏙᏍᏗ ᏣᏚᎵ?
What happened to the crusher? 	ᎦᏙ ᎦᎵᏍᏓ ᎠᏍᏙᏍᎩᎢ?
The barber trims his son's hair.	Ꮎ ᏗᏓᏍᏙᏰᏍᎩ ᎤᏪᏥ ᎠᏧᏣ ᎠᏍᏙᏰᏍᎪᎢ.
Close the door. If someone is drunk, he jails him.	ᎯᏍᏚᎲᎦ ᎦᎶᎯᏍᏗᎢ. ᎤᏴᏍᏕᏓ ᏱᎩ ᎩᎶ ᎠᏍᏚᎲᏍᎪᎢ.
He opens the store at seven o'clock.	ᎦᏟᏉᎩ ᎢᏳᏩᏂᎸ ᎠᏍᏚᎢᏍᎪ ᎠᏓᎾᏅᎢ.
He ate three sandwiches.	ᏦᎢ ᏗᏍᏛᎭᏟ ᏚᎬᎢ.
He sandwiched it between the bread.	ᎦᏚᎢ ᎤᏍᏛᎭᏝᏅᎢ.
Do you think it's going to snow? Maybe.	ᏓᎫᏔᏂᏍ ᎮᎵᎠ? ᎠᏎᏛ.
I felt peculiar for awhile.	ᎠᏎᎩ ᎠᏆᏓᏅᏓᏛ ᏞᎦ.
When he gets here show him where to park the car.	ᎦᎷᏨ ᎯᏯᏎᎮᎸ ᎤᎿ ᎤᏗ ᏓᏆᎴᎳ.
I was going to go outside but it's too cold.	ᏙᏱ ᏓᎨᏏᏒ ᎠᏎᏅ Ꮩ ᎤᏴᏜ.
He forgot to include my friend.	ᎤᏩᎨᏫᏒ ᎤᏎᏍᏙᏗ ᎣᎩᎾᎵᎢ
He withdrew his candidacy for president.	ᎤᎬᏫᏳᎯ ᏱᎦᎵᏍᏗᏍᎩ ᎨᏒ ᎤᏎᏒᎲᎢ.
The motion has been withdrawn.	Ꮎ ᎠᏌᎳᏛ ᎠᏎᏒᏓ ᏂᎦᎵᏍᏓ.
When the boy broke the window, his father reprimanded him .	ᎠᏧᏣ ᏦᎳᏂ ᎤᏲᏍᏔᎾ, ᎤᏙᏓ ᎤᏍᎦᏨᎢ.
I'm afraid of that big dog.	Ꮎ ᎤᏔᎾ ᎩᏟ ᏥᏍᎦᎭ. 
The dog tried to bite the man.	ᎠᏍᎦᏯ ᎤᏍᎦᎵᏍᏗ ᎤᏁᏟᏔᏅ ᎩᏟ.
What is the biggest sin?	ᎦᏙ ᎤᏍᏗ ᏭᏔᏅ ᎠᏍᎦᏂ?
Is there anyone living who is not a sinner?	ᎩᎶᎢᏍ ᎡᎭ ᎠᏍᎦᎾ ᏂᎨᏒᎾ?
He doesn't want to commit a crime .	Ꮭ ᎤᏍᎦᏅᎢᏍᏗ ᏳᏚᎵᎭ.
Do you recognize that man?	ᎯᏲᎵᎦᏍ Ꮎ ᎠᏍᎦᏯ?
The woman said, "My husband is handsome."	"ᎠᏍᎦᏰᎬᏍᏓ ᎣᏍᏗᏁᎵ," ᎤᏛᏅ ᎠᎨᏯ.
An officer is going to inspect the soldiers' uniforms .	ᎠᏍᎦᏰᎬᏍᏓ ᏙᏛᎪᎵᏰᎢ ᎠᏂᏲᏍᎩ ᏚᎾᏄᏮᎢ.
What is the difference between a devil and Satan?	ᎦᏙ ᎤᏍᏗ ᏚᏓᎴᎿᎠ ᎠᏍᎩᎾ, ᏎᏓᏂᏃ?
What did you dream about last night?	ᎦᏙ ᎤᏍᏗ ᏣᏍᎩᏘᏎ ᎤᏒ ᏥᎨᏒᎢ?
A beaver makes a tree fall by gnawing it.	ᎠᏍᎪᎩᏍᎬ ᎦᎴᏴᏍᏗᏍᎪ ᏡᎬ ᏙᏯ.
The little boy mourned for a dead dog.	ᎤᏍᏗ ᎠᏧᏣ ᎩᏟ ᎤᎵᏬᏨ ᎤᏍᎪᏂᎸᎢ.
Rub my head, it hurts.	ᏥᏍᎪᎵ ᎭᏍᎪᎵᏯ, ᎠᏇᎯᏍᏓᏁᎭ.
He erased his name on the paper.	ᏚᏙᎥ ᎤᏍᎪᎸᏛ ᎪᏪᎵᎢ.
Hand me those erasers.	Ꮎ ᏗᏍᎪᎸᏗᏍᏗ ᏗᏙᏍᎬᏏ.
The pretty color on the shirt is fading.	ᎤᏬᏚᎯ ᎤᎵᏑᏫᏒ ᎠᎿᏬ ᎠᏍᎪᎸᎦ.
I am digging a water well.	ᎠᎹᏢᏗ ᎦᏍᎪᏍᎦ.
He rubbed his shins when he stopped running.	ᏗᏍᎬᏓᎨᏂ ᏚᏍᎪᎵᏰᎥ ᎤᎴᏫᏍᏔᎾ ᎠᏟᏒᎢ.
He finishes his work at 4:30.	ᏅᎩ ᎠᏰᏟ ᎠᏍᏆᏗᏍᎪ ᏚᎸᏫᏍᏓᏁᎲᎢ.
His side is hurting from running.	ᎠᏍᏆᎨᏂ ᎤᏪᎯᏍᏓᏁ ᎤᏓᎾᏫᏍᏔᏅᎢ.
When the ball was thrown to him, he caught it.	ᏍᏆᏞᏍᏗ ᏩᎦᏗᏁᎳ ᎤᏍᏆᏞᏒᎢ.
He found a short pencil.	ᎠᏍᏆᎳ ᏗᎪᏪᎶᏗ ᎠᏴᏩᏔ.
Whenever you sharpen a pencil, it becomes shorter.	ᏗᎪᏪᎶᏗ ᏱᎦᏢᎭ ᎠᏍᏆᎶᎪᎢ.
The man broke an axe handle.	Ꮎ ᎠᏍᎦᏯ ᎦᎷᏯᏍᏗ ᎫᎭᏟᏗ ᎤᏍᏆᎵᏒᎢ.
He tried to hit the dog on the head with a bat.	ᎪᏍᏛᏂᏍᏗ ᎬᏗ ᎤᏍᏆᎸᏂᏍᏗ ᎩᏟ ᎤᏁᏟᏔᏅᎢ.
A lot of Mexicans live in Texas.	ᏅᏓᎩ ᏥᏈᏍᏗ ᎠᏂᏍᏆᏂ ᎠᏁᎭ.
He was amazed at how fast his son learned to read.	ᎤᏍᏆᏂᎪᏒ ᎾᎯᏗᏴ ᎤᏕᏠᏆᎥ ᎤᎪᎵᏰᏗ ᎤᏪᏥ ᎠᏧᏣ.
She's sucking on a ripe tomato.	ᏔᎹᏟ ᎤᏩᏅᏒ ᎠᏍᏆᏄᏥᎦ.
When the dog attacked him, he hit it in the stomach with a stick.	ᎩᏟ ᏚᎦᏘᎴᎾ ᎦᎾᏍᏓ ᎬᏗ ᎤᏍᏉᎭᎸᏂᎸᎢ.
He placed his hand on his friend's shoulder.	ᎤᎾᎵᎢ ᎦᏅᏬ ᎤᏏᏔᏛᎢ.
He slapped me for no reason.	ᎪᎱᏍᏗ ᏄᏰᏟᏛᎾ ᎠᏆᏏᏛᏂᎦ.
When I say back up, back up.	ᎭᏏᏄᎦ ᎦᏛᏅ, ᎭᏏᏁᏒᎢ.
Why are you walking backwards?	ᎦᏙ ᎠᏏᏂ ᏣᎢ?
One person spoke at the meeting.	ᎠᏏᏴᏫ ᎤᏬᏂᏒ ᏓᎾᏠᏍᎬᎢ.
I shot a snake in the head with an arrow.	ᎢᎾᏓ ᎠᏍᎪᎵ ᏥᏲᎸ ᎠᏟᏓ ᎬᏗ.
He roped a wild horse.	ᏐᏈᎵ ᎨᏯᏔᎯ ᎤᏍᎳᏛᎢ.
He built a new fence around the garden.	ᎢᏤ ᎤᏐᏯᎸ ᏠᎨᏏ.
The rooster is sitting on the fence.	ᎠᏐᏴ ᎤᎩᎳ ᏥᏔᎦ ᎠᏨᏯ.
When his friend passed by, he waved to him.	ᎤᎾᎵᎢ ᎤᎶᏌ ᎤᏐᎸᏓᎩᎡᎸᎢ.
Press down on it hard.	ᏍᏓᏯ ᎭᏐᏅᏍᏓ.
The man was wounded fighting in a war.	ᏓᎿᏩ ᎠᏟᎲ ᎠᏥᏐᏅᏁ ᎠᏍᎦᏯ.
How long a string do you want?	ᎯᎳ ᎢᎦᏅᎯᏓ ᎠᏍᏘ ᏣᏚᎵ?
I am sopping gravy.	ᎠᏑᏍᏗ ᎦᏑᎠ.
Where is he fishing?	ᎭᏢᏴ ᎠᏑᎲᏍᎦ?
What color are you going to paint the house?	ᎦᏙ ᎤᏍᏗ ᎤᎵᏑᏫᏓ ᏘᏑᏫᏍ ᎦᎵᏦᏕ?
Whenever he is going to work in the garden, he changes his pants.	ᏠᎨᏏ ᏱᏙᏓᏳᎸᏫᏍᏓᏁᎵ, ᎠᏑᎳᎢᏴᏍᎪᎢ.
When he tore his pants while crossing over a fence, he took them off and mended them.	ᎠᏏᎳᏛ ᎠᏓᏬᎯᎳᏗᏍᎬ ᎤᏲᏍᏔᎾ ᎤᏑᎶ ᎤᏑᎴᏒ ᎣᏍᏓ ᏄᏩᏁᎸᎢ.
He put on someone else's pants.	ᏄᏓᎴ ᎩᎶ ᎤᏑᎶ ᎤᏑᎳᏅᎢ.
When did you quit smoking?	ᎯᎳᏴ ᏧᎵᎪᏤ ᎰᎦᏍᎬ?
What length of pants do you wear?	ᎯᎳ ᎢᎦᏅᎯᏓ ᎠᏑᎶ ᎭᏑᎵᏍᎪ?
Do you know how to make gravy?	ᎯᎦᏔᎭᏍ ᎠᏑᏍᏗ ᏦᏢᏗ?
Choose the one that you want.	ᎭᏑᏯᎩ ᎢᏳᏍᏗ ᏣᏚᎵᏍᎬᎢ.
Stir the soup.	ᎭᏑᏴᎳ Ꮎ ᎤᎦᎹ.
When Cherokees cook wild onions, they mix them with eggs.	ᏒᎩ ᎢᎾᎨ ᎡᎯ ᏳᏅᏂᏍᏔᎾ ᎠᏂᏣᎳᎩ, ᏧᏪᏥ ᏓᎾᏑᏴᏍᎪᎢ.
Something smells bad.	ᎪᏍᏗ ᎤᏲ ᎠᏒᎦ.
Do you know anyone who works in a sawmill?	ᎯᏲᎵᎩᏍ ᎩᎶ ᎠᏒᏆᎶᏍᎩ ᏧᎸᏫᏍᏓᏁᎯ?
When it flooded, the water destroyed some of the bridges.	ᎤᏃᎱᎦᎾ ᎢᎦᏓ ᏓᏒᏢ ᏚᏲᏍᏔᏅ ᎠᎹ.
He burned his hand when he touched a hot stove.	ᎤᏬᏰᏂ ᎤᎴᏴᏒ ᎤᏗᏞᎩ ᎣᏏ ᎤᏒᏂᎳ.
It used up one gallon of oil. He drank up a glass full of milk.	ᏑᏟᎶᏓ ᎪᎢ ᎤᏒᏅᎢ. ᎤᎸᏌᏗ ᎧᎵ ᎤᏅᏗ ᎤᏒᏅᎢ.
My grandmother was a Nighthawk.	ᎡᎵᏏ ᎠᏒᏃᏱ ᎨᏒᎢ.
This boy likes to talk to young women.	ᎯᎠ ᎠᏧᏣ ᎠᎾᏔ ᏧᏟᏃᎮᏙᏗ ᎤᎸᏉᏗ.
Do you know what rage is?	ᏣᏅᏔᏍ ᎢᏳᏍᏗ ᎨᏒ ᎠᏔᏝᏬᎯᏍᏗ?
He held his breath for two minutes.	ᏔᎵ ᎢᏯᏔᏬᏍᏔᏅ ᎢᎪᎯᏓ ᎤᏔᏬᏍᏔᏅᎢ.
Moor the boat when you're through fishing.	ᎯᏔᎳᏛ Ꮎ ᏥᏳ ᎭᏑᏃᏅᎢ.
He drilled a hole in the board with a drill.	ᏗᏔᎴᏍᏗ ᎬᏗ ᎤᏔᎴᏒ ᏯᏖᎾ.
Fill the holes in the road with gravel.	ᏅᏯ ᏧᎾᏍᏗ ᎬᏗ ᏘᎧᎵᏣ ᏓᏔᎴᏒ ᏅᏃᎯ.
When you heat water to its boiling point, it steams.	ᏫᎬᎵᏗᏍᎩ ᏯᏙᏔᎾ ᎠᎹ ᎠᏔᏃᎴᎪᎢ.
How old is your teenage daughter?	ᎯᎳ ᎢᏳᏕᏘᏴᏓ ᏤᏥ ᎠᏔᏄᏣ?
When he threw the gunpowder into the fire, it exploded.	ᎪᏛ ᏭᏗᎾ ᎠᏓᏪᎳᎩᏍᎩ ᎤᏔᏍᎩᏒᎢ.
On July fourth people fire firecrackers.	ᎧᏰᏉᎾ ᏅᎩᏁ ᏗᏔᏍᎩᏍᎩ ᏓᏂᏔᏍᎩᏗᏍᎪ ᏴᏫ.
It's dangerous to smoke near a place where explosives are stored.	ᎦᎾᏰᎪ ᎪᎦᏍᏗ ᏗᏔᏍᎩᏍᎩ ᏓᏍᏆᏂᎪᏛ ᎾᎥᎢ.
She kissed her daughter on the forehead.	ᎤᏪᏥ ᎠᎨᏳᏣ ᎠᎬᏓᎨᏂ ᎤᏔᏪᏙᏅᎢ.
She's combing her son's hair.	ᎤᏪᏥ ᎠᏧᏣ ᎠᏔᏬᎠ.
Don't be afraid to ask for it.	ᏞᏍᏗ ᏱᏍᎦᎮᏍᏗ ᏣᏔᏲᏍᏗᎢ.
He wants to join the military service.	ᎠᏂᏲᏍᎩ ᎤᏖᎳᏗᏍᏗ ᎤᏚᎵᎭ.
She is washing dishes.	ᏗᏖᎵᏙ ᏕᎬᏗᏰᎠ.
Don't shake the ladder.	ᏞᏍᏗ ᏥᎯᏖᎸᏂ ᎠᏴᏠ.
She made a shirt for her husband to wear.	ᎠᏘᏟᏗ ᎤᏬᏢᏅ ᎠᏂᏁᎵ ᎤᎿᏬᏍᏗ.
He's leading a blind man.	ᏗᎨᏫ ᎠᏍᎦᏯ ᎠᏘᏂ.
Why do you like to argue?	ᎦᏙ ᏥᏣᎸᏉᏗ ᏣᏘᏲᏍᏗ?
He's always looking for an argument.	ᏂᎪᎯᎸ ᎠᏘᏲᏍᏗ ᎤᏲᎰᎢ.
Someone is running in this direction.	ᎩᎶ ᏛᏟ.
Who would win if you two raced?	ᎦᎪ ᏱᏓᏓᎩᏯ ᏱᏍᏓᏙᎩᏯ?
The man making he speech is a candidate for president of the United States.	Ꮎ ᎠᏍᎦᏯ ᏥᎦᏬᏂ ᎠᎹᏰᏟ ᎤᎬᏫᏳᎯ ᏱᎦᎵᏍᏗᏍᎩ ᎠᏙᎩᏯᏍᎩ.
Is this camera borrowed?	ᎠᏙᎵᏓᏍ ᎯᎠ ᏗᏓᏟᎶᏍᏗᏍᎩ?
Who loaned him the car?	ᎦᎪ ᎤᏙᎵᏍᏔᏁᎢ Ꮎ ᏓᏆᎴᎳ?
How long does he want to borrow it?	ᎯᎳ ᎢᎪᎯᏓ ᎤᏙᏟᏍᏗ ᎤᏚᎵ?
I see something flashing.	ᎪᎱᏍᏗ ᎠᏙᏯᏩᏍᎬ ᏥᎪᏩᏘᎭ.
He took a bite of cornbread.	ᏎᎷ ᎦᏚ ᎤᏥᏍᏕᎥᎢ.
Are you lying to me?	ᏍᏆᏥᎪᏁᎭᏍ?
He doesn't like to take a drink.	Ꮭ ᏳᎸᏉᏗ ᎤᏚᎩᏍᏗ.
He gave him a drink.	ᎠᏚᎩᏍᏗ ᎤᏁᏁᎸᎢ.
He promised to come over next month.	ᏐᎢ ᎦᎴᏍᏗ ᎤᏪᏓᏍᏗ ᎤᏚᎢᏍᏔᏅᎢ.
I listened to him speak for ten minutes.	ᏍᎪᎯ ᎢᏯᏔᏬᏍᏔᏅ ᎢᎪᎯᏓ ᏥᏯᏛᏓᏍᏔᏅ ᎦᏬᏂᏍᎬᎢ.
Ask him what he's going to do.	ᎯᏯᏛᏛᎲᎦ ᏂᏗᏛᏁᎵᏒᎢ.
He hears only when you speak loud.	ᏍᏓᏯ ᏱᎦᏬᏂᏌ ᎩᎳ ᎠᏛᎩᏍᎪᎢ.
She grows beautiful flowers.	ᏧᏃᏚᎯ ᎠᏂᏥᎸᏍᎩ ᏓᏛᎯᏍᏗᏍᎪᎢ.
He is really growing. 	ᎤᏙᎯᏳ ᎠᏛᏍᎦ. 
Do you recognize that young man?	ᎯᏲᎵᎦᏍ Ꮎ ᎠᏫᎾ?
I didn't know you had two teenage boys.	Ꮭ ᏯᏆᏅᏖ ᎠᏂᏔᎵ ᎠᏂᏫᏄᏣ ᏕᏣᎧᎲᎢ.
Eagles build their nests on mountain tops.	ᎣᏓᎸ ᎦᎸᎳᏗ ᏓᎾᏁᏍᏓᏝᎲᏍᎪ ᎠᏬᎭᎵ.
Which room is he in?	ᎦᏙ ᎤᏍᏗ ᎧᏅᏑᎸ ᎠᏯᎠ.
He was walking fast. 	ᎠᏯᏄᎵ ᎠᎢᏒᎢ.
He distributed food among a lot of people.	ᏥᏈᏍᏗ ᏄᎾᏛᏅ ᏴᏫ ᎤᏯᏙᏢ ᎠᎵᏍᏓᏴᏗ.
He became a deacon on August 25, 1973.	ᎦᎶᏂ ᏔᎵᏍᎪ ᎯᏍᎩᏁ, ᏐᏁᎳᏚ ᎢᏍᎪᎯᏥᏆ ᎦᏟᏆᏍᎪ ᏦᎢ ᎠᏯᏙᎯᎯ ᏄᎵᏍᏔᏅᎢ.
Which chapter are you reading?	ᎯᎳ ᎠᏯᏙᏢ ᎯᎪᎵᏰᎠ?
When he was told to wake up, he woke up.	ᎯᏰᎩ ᎠᎪᏎᎳ, ᎤᏰᏨᎢ. 
Sit here in the middle. 	ᎠᎭᏂ ᎠᏰᏟ ᏦᏞᏍᏗ.
Don't wake the baby.	ᏞᏍᏗ ᏥᎯᏰᎢᏍᏔᏂ ᎤᏍᏗᎢ.
He burned half of his body.	ᎠᏰᏟ ᎢᏴ ᎠᏰᎸ ᏚᎴᏴᏒᎢ.
He put the horse inside the barn.	ᏐᏈᎵ ᎤᏂᏴᏍᏗ ᎤᏴᏔᏅ ᏐᏈᎵ.
Have you heard a hen crowing?	ᏣᏛᎦᏅᎢᏍ ᏥᏔᎦ ᎠᎩᏏ ᎠᏴᎬᎢ?
He got five new pencils from the store. She picked up a pencil from the ground.	ᎯᏍᎩ ᏗᏤ ᏗᎪᏪᎶᏗ ᏚᏴᎲᏗᏓ ᎾᏅᎢ. ᎡᎳᏗ ᏩᏯ ᏗᎪᏪᎶᏗ.
She accidently spilled water on the floor.	ᎠᎹ ᎤᏤᏩᏍᏙᏔᏅ ᎠᏙᏓᏝᎲᎢ.
The bottle broke when it dropped.	ᎫᎫ ᎤᏲᏨ ᎤᏬᎰᏌ.
The hunter shot a dear with an arrow.	ᎦᏃᎭᎵᏙ ᎦᏟᏓ ᎬᏗ ᎤᏲᏢ ᎠᏫ.
What time do you take a break from your work.	ᎯᎳ ᎠᏟᎢᎵᏒ ᎯᏲᎯᏍᏗᏍᎪ ᏕᏣᎸᏫᏍᏓᏁᎲ?
The children are playing ball. He picked up some small rocks.	ᏗᏂᏲᏟ ᏍᏆᎴᏍᏗ ᏓᎾᏁᎶᎲᏍᎦ. ᏗᏲᏟ ᏅᏯ ᏚᏭᏖᏒᎢ.
Several men are hewing railroad ties.	ᎢᎸᏍᎩ ᎢᏯᏂᎢ ᎠᏂᏍᎦᏯ ᏗᏗᏍᏗ ᏓᏂᏲᏢᏍᎦ.
No one hides from death. 	Ꮭ ᎩᎶ ᏴᎬᏗᏍᎦᎳᏍ ᎠᏲᎱᎯᏍᏗ. 
When did he die? 	ᎯᎳ ᎢᏴ ᏥᎨᏒ ᎤᏲᎱᏎᎢ?
He broke up a fight between the little boys.	ᏧᎾᏍᏗ ᎠᏂᏧᏣ ᎠᎾᏟᎲ ᎤᏲᎢᏍᏔᏅᎢ.
Every time he sees me, he greets me. 	ᏂᎪᎯᎸ ᏯᎩᎪᎭ ᎠᎩᏲᎵᎰᎢ.
He accidently broke a water glass.	ᎠᎹ ᎠᏟᏍᏙᏗ ᎤᎸᏌᏗ ᎤᏲᏍᏙᏔᏅᎢ.
I was a soldier for three years.	ᏦᎢ ᏧᏖᏗᏴᏓ ᏥᏲᏍᎩ ᎨᏒᎢ.
The wind destroyed the small building.	ᎤᏟᏂᎩᏓ ᎦᏃᎸᏍᎬ ᎤᏲᏍᏔᏃᎲ ᎤᏍᏗ ᎠᏓᏁᎸᎢ.
a crippled man asked for a walking cane.	ᎠᏲᎤᏟ ᎠᏍᎦᏯ ᎠᏙᎳᏅᏍᏗ ᎤᏔᏲᎸᎢ.
Do you want me to go?	ᎠᏯᏍ ᎠᏇᏅᏍᏗ ᏣᏚᎵ?
I entered the house when the rain came.	ᎦᎵᏦᏕ ᎠᎩᏴᏢ ᎤᎦᎿᏂᏝ.
The boy found a new bat.	Ꮎ ᎠᏧᏣ ᎢᏤ ᎪᏍᏛᏂᏍᏗ ᎤᏴᏩᏛᎲᎢ.
Where are you taking the wood?	ᎭᏢ ᏕᎯᏴᏫᏗ ᎠᏓ?
There is a gate at the entrance to the pasture.	ᏍᏚᏗ ᎬᏙᎠ ᎠᏴᏍᏙᏗ ᏠᎨᏏ.
What are the people doing?	ᎦᏙ ᎠᎾᏛᏁ ᎠᏂᏴᏫ?
This boy is a full-blooded Indian.	ᎯᎠ ᎠᏧᏣ ᎠᎧᎵ ᎠᏴᏫᏯᎢ.
Have you heard a white person speak Cherokee?	ᏣᏛᎦᏅᎢᏍ ᎠᏲᏁᎦ ᏣᎳᎩ ᎦᏬᏂᏍᎬ?
Give him eight dollars.	ᏣᏁᎳ ᎠᏕᎸ ᏘᎥᏏ.
He burns coal in his heating stove.	ᏥᏃᏍᎦ ᎠᎪᎲᏍᏗᏍᎪ ᎣᏏ ᎤᎦᎾᏬᎯᏍᏗᎢ.
Do you have some flea killer?	ᏧᎦᏍ ᏗᎮᏍᏙᏗ ᏣᏁᎭ?
He made an X on the signature line because he didn't know how to write his name in English.	ᏚᏙᎥ ᎤᏬᏪᎶᏗ ᎠᏍᏓᏅᏅ ᏚᏓᎿᏫᏍᏔᏅᎢ ᎾᎦᏔᎲᎾ ᎨᏒ ᎢᏳᏍᏗ ᎩᎵᏏ ᎤᏬᏪᎶᏗᎢ.
They met at a crossroads.	ᏓᏓᎿᏫᏍᏛ ᏅᏃᎯ ᏚᎾᏠᏒᎢ.
He looked for his conjuring material when he was asked to conjure.	ᏓᏓᏁᏎᏍᎬ ᎤᏮᏔᏂᏓᏍᏗ ᎤᏯᎸ ᏧᏓᏁᏎᏍᏗ ᎠᏥᏔᏲᏎᎳ.
Do you think he is going to accept? 	ᏚᏛᏓᏂᎸᏥᏍ ᎮᎵ?
Why didn't you dodge?	ᎦᏙᎲ Ꮭ ᏱᏙᏣᏓᏅᏗᏍᏔᏁ?
The preacher performed baptism on a cold day.	ᎤᏴᏟ ᎢᎦ ᏚᏓᏬᎥ ᎠᎵᏣᏙᎲᏍᎩ.
He lasted a long time, then he gave up.	ᎪᎯᏓ ᏚᏪᏘᏅ ᎩᎳ ᏚᏓᏲᏒᎢ.
She teaches summer school.	ᎪᎩ ᏓᎾᏕᏠᏆᏍᎬ ᏓᏕᏲᎲᏍᎪᎢ.
The shortest verse in the bible says, "Jesus wept."	ᏩᏍᏆᎳᎯᏴ ᎤᏓᏡᎬ ᎦᎸᏉᏗ ᎪᏪᎵ, "ᏥᏌ ᏚᏠᎯᎸᎢ," ᎠᏗᎭ.
They were married in a chapel last month.	ᏧᏂᎳᏫᏍᏗ ᏕᎨᎦᏨᏍᏔᏅ ᏐᎢ ᏥᎧᎸᎢ.
They make necklaces out of pearls.	ᏗᏯᎵᏗ ᏓᏃᏢᏅᏗᏍᎪᎢ ᏓᎬᎾ.
Whatever price you set, I'll pay you.	ᏂᎦᎵᏍᏔᏅᏊ ᎢᎦ ᏕᎯᎬᏩᎶᏔᏅ ᎬᏯᏈᏴᎡᎸᎢ.
When he gets to town, the man is going to buy a car.	ᏗᎦᏚᎲ ᏫᎦᎷᏨ ᎠᏍᎦᏯ, ᏓᏆᎴᎳ ᏓᏳᏩᏏ.
She saw a rocking chair rocking by itself.	ᎦᏍᎩᎶ ᏗᏟᎨᏍᎩ ᎤᏩᏌ ᏓᏟᎨᏍᎬ ᎤᎪᎲᎢ.
He drew a picture of a bear.	ᏲᎾ ᏚᏟᎶᏍᏔᏅᎢ?
I was conversing on the phone.	ᏗᏟᏃᎮᏗ ᏕᎦᎵᏃᎮᏍᎬᎢ.
How high can you jump? 	ᎯᎳ ᎢᏯᎦᎸᎳᏗ ᎡᎵᏊ ᏱᏕᎭliᏔᏚᎦ.
Do you think that war will ever cease?	ᎢᎸᎯᏳᎢᏍ ᏙᎢ ᏂᏓᎦᎵᏍᏔᏂ ᎮᎵ ᏓᎿᏩ?
He changed his wet clothes. 	ᏗᎦᏚᎵᏓ ᏚᏄᏮ ᏚᎿᏩᎢᏴᏒᎢ.
I am undressing to go to sleep.	ᏕᎦᏂᏪᎠ ᎠᎩᏒᏍᏗ ᎤᎬᏩᏟ.
Put on some clean clothes.	ᏧᏓᏅᎦᎸᏓ ᏔᎿᏬᏣ.
Is there a stompground near Vian? 	ᏓᏄgo ᎾᎥ ᎪᏢ ᎦᏘᏲᎢ.
He put green wood into the stove. 	ᏗᏤ ᎠᏓ ᏚᎲᏔᏅ ᎣᏏᎢ.
Don't tickle me while I'm eating.	ᏞᏍᏗ ᏥᏙᏍᎩᏴᎩ ᎦᎵᏍᏓᏴᎲᏍᎬᎢ.
Which one is better? 	ᎦᏙ ᎤᏍᏗ ᏓᏤᏝ.
He couldn’t get up from a squatting position.	ᎤᏄᎸᏅ ᏧᎴᏗ ᏕᎦᏥᏡᎬᎢ. 
He is tying my shoe laces for me. 	ᏓᏆᎸᏌᏛ ᏓᎩᎧᏁᎮᎭ.
He untied his shoes when he took them off .	ᏚᎳᏍᏑᏢ ᏚᎧᏁᏴᎲ ᏚᎳᏑᎴᏌ.
Who is looking after you? 	ᎦᎪ ᏕᏣᎧᏃᏩᏗᏙᎭ?
If you're in the dark for a long time, you'll become blind.	ᎪᎯᏓ ᎤᎵᏏᎬ ᏴᏯᎠ ᏱᏛᎨᏩᎩ.
I saw a terrapin crossing the road.	ᏓᎩᏏ ᏅᏃᎯ ᏚᎾᏗᏫᏏᏗᏒ ᏥᎪᏩᏔ.
He opened the lock with a wire.	ᎤᏯᏅ ᎬᏗ ᎤᏍᏚᎢᏒ ᏓᎩᏏ.
The electrical wires smoked when they became hot.	ᏗᎾᎦᎵᏍᎩ ᏧᏯᏅ ᏚᎦᏒᏍᏔᏅ ᏚᏖᏴᏌ.
She was blinking because she had tears in her eyes.	ᏚᎦᎳᏁᏒ ᎢᏳᏍᏗ ᏓᎦᏔᎾᏩᏍᎬᎢ.
He closed his eyes when he was blinded by a bright light.	ᏚᎦᏔᏍᏔᏅ ᎤᏍᎪᏍᏗ ᎠᏨᏍᏛ ᏚᎦᏙᏴᏌ.
A lion attacked the lion tamer.	ᏢᏓᏥ ᏗᏏᎾᎲᏍᏗᏍᎩ ᏢᏓᏥ ᏚᎦᏘᎸᏒᎢ.
When she takes off her glasses, she doesn't see well.	ᏱᏚᎦᏘᏅᏕᏌ Ꮭ ᎣᏍᏓ ᏯᎪᏩᏘᏍᎪᎢ.
When some people are in the sun, they put on dark glasses.	ᎢᎦᏓ ᎠᎦᎵᏍᎬ ᏯᏁᏙᎭ ᏧᎵᏏᎩ ᏗᎦᏘᏅᏘᏗ ᏓᎾᎦᏘᏅᏛᏍᎪᎢ.
He shelled a bushel of corn for the horse to eat.	ᏚᏟᎶᏓ ᎢᎦ ᏎᎷ ᏚᎦᏢᎲ ᏐᏈᎵ ᎤᎩᏍᏗ.
Who was snoring last night?	ᎦᎪ ᏓᏆᎳᎩᏍᎨ ᎤᏒ ᏥᎨᏒ?
She is sprinkling water on the clothes she is going to iron.	ᎠᎹ ᏓᏆᏲᎥᏍᎦ ᏗᎿᏬ ᏧᏖᏍᏗ.
Do you like turnips?	ᏓᏈᏌᏂᏍ ᏗᏣᎸᏉᏗ?
A cat caught a woodpecker.	ᏓᎳᎳ ᎤᏂᏴᎲ ᏪᏌ.
Bill wants to put on some new shoes.	ᏗᏤ ᏗᎳᏑᎶ ᏧᎳᏑᏢᏗ ᎤᏚᎵ ᏫᎵ.
He changed shoes because they were too long	ᏚᎳᏑᎳᎢᏴᏒ ᏗᎦᏅᎯᏗ ᎨᏒ ᎢᏳᏍᏗ ᏗᎳᏑᎳ.
Take your right shoe off.	ᎠᎦᏘᏏ ᏗᏜ ᏣᎳᏑᏢ ᎭᎳᏑᎳᎩ.
If he can't get up, help him up.	ᎤᏄᎸᎲᏍᎨᏍᏗ ᏧᎴᏗ ᏕᎯᏯᎴᏔᏅᎢ.
He's recuperating in a hospital.	ᏧᏂᏢᎩ ᏩᏯᎥ ᏓᎴᎯᏏᎭ.
When I say stand up, everyone stand up. 	ᏗᏣᎴᎲᎦ ᎦᏛᏅ, ᏂᎦᏓ ᏕᏣᎴᏅᎢ.
Tahlequah is the capitol of the Cherokee Nation of Oklahoma.	ᏓᎵᏆ ᏣᎳᎩ ᎠᏰᏟ ᎤᏙᏢᏒᎢ ᎣᎦᎵᎰᎻ.
I'm going to take my gloves off. What about you?	ᏙᏓᎦᎵᏰᏑᎴᏏ. ᏂᎯᎾ?
I am putting on gloves because I am going to work.	ᏕᎦᎵᏰᏑᎵ ᏙᏛᎩᎸᏫᏍᏓᏁᎵᎮᏃ
He took off his shoes and socks.	ᏚᎳᏑᎴᏒ ᎠᎴ ᏚᎵᏲᎩᏒᎢ
While he was putting on his socks, someone stole his shoes.	ᏓᎵᏲᎯᎲ ᎢᎪᎯᏓ ᎩᎶ ᏚᏃᏍᎩᏎ ᏧᎳᏑᎶ.
Change your wet socks.	ᏔᎵᏲᏌ ᏗᎦᏚᎵᏓ ᏕᏣᎵᏲᎲᎢ.
Don't aim at anyone with a gun.	ᏞᏍᏗ ᎩᎶ ᎦᎶᏇ ᎬᏗ ᏱᏘᏯᎵᏐᏍᏗᏍᎨᏍᏗ.
A horsefly bites hard.	ᏓᎹᎦ ᏍᏓᏯ ᎠᏓᏍᎦᎵᎪᎢ
They will be having a trial on Monday.	ᎤᎾᏙᏓᏉᏅ ᏓᎾᏓᎯᎵᏙᎮᏍᏗ.
A lot of Cherokees met at Tahlequah in order to hear the chief speak .	ᏥᏈᏍᏗ ᎠᏂᏣᎳᎩ ᏚᎾᏠᏒ ᏓᎵᏆ ᎤᎬᏫᏴᎯ ᎦᏬᏂᏍᎬ ᎤᎾᏛᎪᏗ ᎤᏂᏰᎸᏒᎢ.
Why did they separate?	ᎦᏙᎲ ᏚᎾᎦᎴᏅᎮᎢ?
What is the little boy playing with?	ᎦᏙ ᎤᏍᏗ ᏓᏁᎶᏗ Ꮎ ᎤᏍᏗ ᎠᏧᏣ?
I'm going to play ball all day tomorrow	ᏍᏆᏞᏍᏗ ᏙᏓᎦᏁᎶᏂ ᏑᎾᎴ ᎤᏙᏓᏆᏓ
Cherokee hold church services on Saturday nights.	ᎠᏂᏣᎳᎩ ᎤᏙᏓᏈᏕᎾ ᎤᏒ ᏓᏂᎳᏫᎪᎢ.
What did you get for Christmas?	ᎦᏙ ᎤᏍᏗ ᏣᎩᏎ ᏓᏂᏍᏓᏲᎯᎲᎢ?
When are they going to adjourn?	ᎯᎳ ᎢᏴ ᏙᏛᏂᏰᎵᏍᏗ?
He barely shot the gun because the trigger was hard to pull.	ᏎᎦᏨ ᏚᏍᏓᏲᏢ ᎦᎶᏇ ᎠᏍᏓᏴ ᎪᏣᏁᏍᏗᎢ ᎢᏳᏍᏗ.
He's splitting some cook wood.	ᎣᏏ ᎠᏓᏍᏓᏴᏗ ᏧᎲᏘᏗ ᎠᏓ ᏓᏍᏡᏍᎦ.
I am sprinkling water on my cucumbers.	ᎦᎦᎹ ᏓᎩᏫᏒ ᎠᎹ ᏕᏥᏍᏚᏟᎠ.
The treasurer is counting money.	ᎠᏕᎳ ᎠᎦᏘᏱ ᎠᏕᎳ ᏓᏎᎯᎭ.
He curses when something makes him angry.	ᏓᏍᎩᎾᏗᏍᎪ ᎪᏍᏗ ᏳᎿᎸᏍᏔᎾ.
When the president finished his speech, the people applauded.	ᎤᎬᏫᏳᎯ ᎤᏬᏂᏐᎿ ᏚᎾᏏᏛᏂᎸ ᏴᏫ.
Don't work so hard or you'll get exhausted.	ᏞᏍᏗ ᎥᏍᎩ ᎢᏍᏓᏱ ᏱᏗᏣᎸᏫᏍᏓᏁᎮᏍᏗ, ᏙᏔᏍᏔᏰᏏᏍ.
When it becomes light, the dog barks.	ᎤᏒ ᏱᏄᎵᏍᏔᎾ, ᎩᏟ ᏓᏑᏫᏍᎪᎢ.
He scheduled his speech for Monday night when asked to speak.	ᎤᎾᏙᏓᏉᏅ ᎤᏒ ᎤᏬᏂᎯᏍᏗ ᏚᏒᏍᏔᏅᎢ ᎬᏩᏔᏲᏎᎳ ᎤᏬᏂᎯᏍᏗᎢ.
What time did you start ironing?	ᎯᎳ ᎠᏟᎢᎵᏒ ᏣᎴᏅᎮ ᏕᎯᏖᏍᎬᎢ?
He found an arrowhead made out of flint.	ᏓᏫᏍᎦᎳ ᎪᏢᏔᏅ ᎦᏟᏓ ᎤᏍᎧ ᎤᏩᏛᎲᎢ
When it freezes, the roads get slippery.	ᏳᏁᏍᏓᎳᏓ ᏕᎦᏅᏅ ᏓᏫᏍᎬᎯ ᏂᏕᎦᎵᏍᏗᏍᎪᎢ.
Some mushrooms are good to eat but others are poisonous.	ᎢᎦᏓ ᏓᏬᎵ ᎠᏃᏍᏓ ᏗᎦᏰᏍᏗ ᎢᎦᏓᏃ ᎠᎾᏓᎯᎯ.
He stopped the leak in the tub with a cork.	ᏓᏬᎵᏳᏍᏗ ᎬᏗ ᎤᏍᏚᏅᎢ ᏒᏙᏂ ᎬᎫᏍᎬᎢ.
Let the rabbit go.	ᏘᏲᎯ ᏥᏍᏚ.
She picked a sack full of hickory nuts.	ᏕᎦᎵᏗ ᎧᎵ ᏚᏭᏖᏒ ᏐᎢ.
He slammed the door when he went out.	ᏍᏚᏗ ᏚᎸᏛᏂᏍᏔᏅ ᎤᏅᎪᏣ.
I saw a deer crossing a road last night.	ᏅᏃᎯ ᏕᎦᎾᏗᏫᏍᎬ ᏥᎪᎥ ᎠᏫ ᎤᏒ ᏥᎨᏒᎢ.
I want to announce something.	ᎪᎱᏍᏗ ᏗᎩᏃᏣᏢᏗ ᎠᏆᏚᎵᎭ.
I crossed the ocean when I was in the military service.	ᎠᎺᏉ ᏓᎩᏐᏨ ᎠᏂᏲᏍᎩ ᏥᏥᏯᎥᎢ.
He endured working in the heat all day.	ᎤᏙᏓᏆᏓ ᏚᏪᏘᏅ ᎤᏗᏞᎩ ᏚᎸᏫᏍᏓᏁᎲᎢ.
The Sunday School teacher explained what they had read.	ᎤᎾᏙᏓᏆᏍᎬ ᏗᎾᏕᏠᏆᏍᎩ ᏗᎨᏲᎲᏍᎩ ᏚᏬᏏᏌᏅ ᎤᏂᎪᎵᏰᎥᎢ.
He decided too quickly.	ᎤᏟᏍᏗ ᏚᏭᎪᏔᏅᎢ.
She washes the dishes immediately after they finish eating.	ᏳᎾᎵᏍᏓᏰᏃᎿᏊ ᏕᎬᏗᏰᏍᎪ ᏗᏖᎵᏙᎢ.
She's shelling peas. How many hickory nuts are you going to shell?	ᏚᏳᎾᏍᏗ ᏕᎬᏙᎯᎠ. ᎯᎳ ᎢᎦ ᏐᎯ ᏙᏛᏙᎯᏏ?
Summer begins in the month of June.	ᏕᎭᎷᏱ ᎧᎸ ᎠᏓᎴᏂᏍᎪᎢ ᎪᎩ.
When he went around the curve too fast, he turned the car over.	ᎦᏣᏄᎵ ᎤᏩᏕᏯᏍᏔᎾ ᎠᏕᏲᎲ ᏚᏟᏆᏗᏅᏒ ᏓᏆᎴᎳ.
The singers sang all night.	ᎤᎵᏨᏓᏆᏓ ᏚᏂᏃᎩᏒ ᏗᏂᏃᎩᏍᎩ.
The cat clawed him with its sharp claws.	ᏗᎪᏍᏓᏯ ᏚᏑᎦᏢ ᎬᏗ ᏚᏄᎪᏒ ᏪᏌ.
What are you doing, washing?	ᎦᏙ ᎭᏛᏁ, ᏕᎲᎩᎶᎠᏍ?
Where did marriage begin?	ᎭᏢ ᏧᏓᎴᏅᎮ ᏗᏨᏍᏗ?
The murderer was taken to jail when he was caught.	ᏧᎾᏓᏍᏚᏗ ᎠᎦᏘᏅᏒ ᏗᏓᎯᎯ ᎠᏥᏂᏴᎭ.
The lawyer is going to the courthouse.	ᏧᎾᏓᎯᎵᏓᏍᏗ ᎡᎦ ᏗᏘᏲᎯᎯ.
A photographer came to the ball game.	ᏗᏓᏟᎶᏍᏗᏍᎩ ᎤᎷᏨ ᎠᎾᎳᏍᎦᎵᏍᎬᎢ
Whose photograph is this?	ᎦᎪ ᎤᏤᎵ ᎯᎠ ᏗᏓᏟᎶᏍᏔᏅᎢ?
Some graves have crosses.	ᎢᎦᏓ ᏓᏤᎵᏍᏛ ᏧᏓᎿᏫᏓ ᏕᎨᏙᎢ.
Do you know where a conjurer lives?	ᏣᏅᏔᏍ ᎤᎿ ᎦᏁᎸ ᏗᏓᏁᏎᏍᎩ?
That man is a Cherokee medicine man.	Ꮎ ᎠᏍᎦᏯ ᎠᏣᎳᎩ ᏗᏓᏅᏫᏍᎩ.
That little boy wants to become a surgeon when he grows up.	Ꮎ ᎤᏍᏗ ᎠᏧᏣ ᏗᏓᏰᏠᎯ ᎢᏳᎵᏍᏙᏗ ᎤᏚᎵ ᎠᏛᏒᎢ.
He went back home a while ago.	ᏗᏓᏁᎸ ᏨᎤᏪᏅᏒ ᎪᎯ.
An old man is cleaning some dentures.	ᎤᏛᏐᏅ ᏗᏓᏅᏙᏍᏗ ᏕᎦᏅᎦᎵᎠᎭ.
Some men are working in the cemetery mowing grass.	ᏗᏓᏂᏐᏗ ᏚᏂᎸᏫᏍᏓᏁ ᎠᏂᏍᎦᏯ ᎦᏄᎸ ᎠᏂᎦᎵᏍᎦ.
I want to talk with a policeman.	ᏗᏓᏂᏱᏍᎩ ᎣᎩᎾᏟᏃᎮᏗ ᎠᏆᏚᎵ
He chose five cooks to cook.	ᎯᏍᎩ ᎢᏯᏂᎢ ᏗᎾᏓᏍᏓᏴᎲᏍᎩ ᏚᏑᏰᏒ ᎤᎾᏓᏍᏓᏴᏗᎢ.
He went to a school for barbers.	ᏗᎾᏓᏍᏙᏰᏍᎩ ᏧᎠᏕᏠᏆᏍᏗ ᏚᏕᏠᏆᎥᎢ.
Have you been in jail?	ᏣᏴᏢᎢᏍ ᏧᎾᏓᏍᏚᏗ?
Where's the leader of your group?	ᎭᏢ ᏗᏓᏘᏂᏙᎯ ᎢᏣᏓᏡᎬᎢ?
They formed a loan association in a big city.	ᎠᏕᎳ ᏗᎾᏓᏙᎵᏍᏗᏍᎩ ᎤᎾᏙᏢᏅ ᎤᏔᎾ ᎦᏚᎲᎢ.
He became a deacon in a First Baptist Church.	ᎢᎬᏱ ᏗᎾᏓᏬᏍᎩ ᏧᏂᎳᏫᏍᏗ ᎠᏯᏙᎯᎯ ᏄᎵᏍᏔᏅᎢ.
Ninety students graduated this spring.	ᏐᏁᎳᏍᎪᎯ ᎢᏯᏂᎢ ᏗᎾᏕᏠᏆᏍᎩ ᏚᏂᏍᏆᏛ ᎪᎯ ᎪᎨᏱ.
She's been a teacher for a few years.	ᎢᎸᏍᎩ ᏧᏕᏘᏴᏓ ᏗᏕᏲᎲᏍᎩ ᏂᎨᏐᎢ.
I saw him walking toward the road.	ᏅᏃᎯ ᏗᏜ ᏩᎢᏒ ᏧᏫᏥᎪᏩᏔ.
I couldn't find the meeting place.	ᎠᏆᏠᏨ ᎤᎿ ᎪᏢᏒ ᏗᏠᎯᏍᏗᎢ.
Don't let excuses get in your way.	ᏞᏍᏗ ᏗᏢᏈᏍᏙᏗ ᎢᎬᏱ ᏗᏜ ᏥᏂᏣᏛᏁᎵ.
How much does a bushel of pears cost?	ᎯᎳ ᏧᎬᏩᎵᏗ ᏑᏟᎶᏓ ᏗᎦᏛᏗ?
How many churches are there in the city of Tahlequah?	ᎯᎳ ᎢᎦ ᏕᎪᏢ ᏧᏂᎳᏫᏍᏗ ᏓᎵᏆ ᎦᏚᎲᎢ?
The long-eared hound dog got his ear caught in the fence because his ear was so long.	ᏗᎦᎴᏅᎯᏓ ᎩᏟ ᏗᎦᎴᏅᎯᏓ ᎠᏏᎳᏛ ᎤᏭᏓᎸᏤᎸ ᎦᎴᏂ ᎦᏅᎯᏒ.
The farmer's crop became dry because of no rain.	ᏗᎦᎶᎩᏍᎩ ᎤᏫᏒᏅ ᎤᎧᏲᏐᏅ ᎾᎦᏍᎬᎾ ᎨᏒ ᎢᏳᏍᏗ.
Do you think there are enough dumplings?	ᎡᎵᏊᏍ ᏂᎦᎠ ᏗᎦᎸᏅᎯ ᎮᎵᎠ?
Does anyone have an announcement?	ᎩᎶᏍ ᎪᎱᏍᏗ ᏗᎦᏃᏣᎸᏗ ᎤᎭ?
She put the pies in the pantry.	ᏗᎦᎾᏐᏗ ᏫᏚᏝᏅᏗᎨᎵᏍᏘᎩ.
He's ticklish in his ribs.	ᏗᎦᏄᎳᏥ ᏧᏴᎩᏌᏘ.
I have bread in the oven.	ᏗᎦᏘᏗ ᏩᎩᏝ ᎦᏚ.
Some people use gigs whenever they hunt crawdads.	ᎢᎦᏓ ᏗᎦᏘᏍᏗ ᏓᏅᏗᏍᎪ ᏥᏍᏛᎾ ᏱᏚᏂᏯᎳ.
I am reading a book.	ᏗᎪᏪᎵ ᏕᏥᎪᎵᏰᎠ.
While they were wrestling, he was accidently stabbed with a pencil.	ᎠᎾᏁᎯᎲ ᏗᎪᏪᎶᏗ ᎬᏗ ᎠᏥᏘᏍᏙᏔᏅᎢ.
He asked for a discussion when he read the Bible.	ᏗᎪᏏᏐᏗ ᎤᏔᏲᏢ ᎦᎸᏉᏗ ᎪᏪᎵ ᎤᎪᎵᏰᎠ.
I just saw a mud dauber sting a spider.	ᎧᎾᏁᏍᎩ ᎦᏨᏍᎬ ᏥᎪᏩᏔ ᏗᎫᎵᏗᏍᎩ.
The judge sentenced him to thirty days in jail.	ᏦᏍᎪ ᏧᏒᎯᏓ ᏧᎾᏓᏍᏚᏗ ᎤᏴᏍᏗ ᏚᏬᎪᏓᏁᎸ ᏗᎫᎪᏗᏍᎩ.
He has a dog that's a snake killer.	ᎢᎾᏓ ᏗᎯᎯ ᎩᏟ ᎤᏩᎧᎭ.
Do you hear a telephone ringing?	ᏗᏟᏃᎮᏗᏍ ᎤᏃᏴᎬ ᎭᏛᎩ?
He wants to become a high jumper.	ᎦᎸᎳᏗ ᏗᎵᏔᏕᎩ ᎢᏳᎵᏍᏙᏗ ᎤᏚᎵᎭ.
The wealthy have expensive clothes.	ᏧᏁᎿᎢ ᏥᏈᏍᏗ ᏧᎬᏩᎵᏗ ᏗᎿᏬ ᏚᏂᎾᎣᎢ.
How many covers do you want?	ᎯᎳ ᎢᎦ ᏗᎿᏬᏍᏙᏗ ᏕᏣᏚᎵᎭ?
I was a wrestler when I was in the twelfth grade.	ᏗᎦᏁᎯᎯ ᎨᏒ ᏔᎵᏚᏏᏁ ᏗᏥᏂᏙᎯ ᏥᎨᏒᎢ.
A carpenter is buying some tools.	ᎬᏔᏅᏙᏗ ᎤᏩᏒᏍᎦ ᏗᏁᏍᎨᏍᎩ.
He has spurs on his boots.	ᏗᏴᎩᏍᏗ ᏂᏚᏩᏅᏗ ᏚᎳᏑᏢᎢ.
I learned to read Cherokee when I was fourteen years old.	ᏂᎦᏚ ᎢᏯᏆᏕᏘᏴᏓ ᏥᎨᏒ ᎠᏆᏕᏠᏆᎥ ᏗᏣᎳᎩ ᏗᎩᎪᎵᏰᏗᎢ.
He went toward the east.	ᏗᎧᎸᎬ ᏗᏜ ᏭᎶᏒᎢ.
They use musical instruments when they sing.	ᏗᎧᏃᎩᏍᏗ ᏓᏅᏗᏍᎪ ᏱᏚᏂᏃᎩᏌ.
Do angels have wings?	ᏓᏃᏯᏓᏍ ᏗᏂᎧᏃᏩᏗᏙᎯ?
When some people break the law, they get away with it.	ᏗᎧᏃᏩᏛᏍᏗ ᏱᏚᏂᏲᏍᏔᎾ ᎢᎦᏓ ᎬᏩᎩᏘ ᎾᎾᏛᏁᎰᎢ.
The firemen have three new firetrucks.	ᏦᎢᎭ ᏗᏤ ᏗᎬᏜᏗᏍᎩ ᏚᏂᎭ ᏗᏅᏜᏗᏍᎩ.
Hand me a sharpener . I'm going to sharpen a knife.	ᏗᎬᏢᏗ ᎡᏍᎬᏏ. ᎭᏰᎵᏍᏗ ᏓᎬᏢᎯ.
This man is blind.	ᎯᎠ ᎠᏍᎦᏯ ᏗᎨᏫ.
He had to get eyeglasses.	ᏗᎦᏘᏅᏘᏗ ᏧᎩᏍᏗ ᏄᎵᏍᏔᎾᎢ.
If you look at him with binoculars, you'll recognize him.	ᏗᎦᏙᏗ ᎬᏗ ᏳᏫᏯᎦᏔᎿ ᏱᏲᎵᎩ.
He lost a new deck of cards.	ᏗᏤ ᏗᏆᎾᏲᏍᏗ ᏚᏲᎱᏏ.
I put pepper on my eggs.	ᏗᏆᏲᏗ ᏕᏥᏆᏲᎥᏍᎪ ᏧᏪᏥ.
She likes to use sharp scissors while sewing.	ᏗᎪᏍᏓᏱ ᏗᎵᏍᏙᏰᏗ ᏧᏮᏙᏗ ᎤᎸᏉᏗ ᎦᎮᏫᏒᏍᎬᎢ.
Are these boys brothers? His brother is coming in a little while.	ᏗᎾᏓᏅᏟᏍ ᎯᎠ ᎠᏂᏧᏣ? ᎪᎯᏴ ᏓᎦᎷᏥ ᏗᎾᏓᏅᏟ.
Did you get the toy you wanted?	ᏣᏚᎵᏍᎬᎢᏍ ᎢᏳᏍᏗ ᏗᏁᎵᏙᏗ ᏣᎩᏎ?
Why did they become enemies? When he saw his enemy coming, he ran away.	ᎦᏙᎲ ᏗᏂᏓᎿᏫ ᏄᎾᎵᏍᏔᏁᎢ? ᏗᏂᏓᎿᏫ ᏣᎢᏒ ᏭᎪᎭ, ᎤᎵᏘᏒᎢ.
Help me move a dresser.	ᏗᏎᎯᏍᏗ ᎦᏍᎩᎵᏴᏒ ᏍᎩᏍᏕᎳ.
Do you know your numbers?	ᏕᎯᎦᏔᎭᏍ ᏗᏎᏍᏗ?
I want three gallons of paint.	ᏦᎢ ᎢᏳᏟᎶᏓ ᏓᏟᏍᏛ ᏗᏑᏫᏍᏗ ᎠᏆᏚᎵᎭ.
I am looking for an electric drill.	ᎠᎾᎦᎵᏍᎩ ᎠᏂᎩᏍᏗᏍᎩ ᏗᏔᎴᏍᏗ ᎠᎩᏲᎭ.
The iron isn't heating up.	Ꮭ ᏯᏖᏴᏍᎦ ᏗᏖᏍᏗ.
When did he become a lawyer?	ᎯᎳ ᎢᏴ ᏗᏘᏲᎯᎯ ᏄᎵᏍᏔᏁ?Ꭲ?
Someone is gathering poke.	ᎩᎶ ᏜᎢᏓ ᏂᎬᎾᏕᏏᏙᎭ.
Bats live in caves.	ᎤᏍᏓᎦᎸ ᎠᏂᏁᎶᎢ ᏜᎺᎭ.
How big do leeches get?	ᎯᎳ ᎢᏗᏂᏓ ᎾᎾᎵᏍᏗᏍᎪ ᏜᏄᏏ?
The town of Jay, Oklahoma, was named after the bluejay.	ᏜᏱᎬ, ᎣᎦᎳᎰᎻ, ᎦᏚᎲ ᏥᎩ ᏜᏱᎦ ᏚᏙᏍᏔᏁᎢ.
He's in jail in Jay.	ᏜᏱᎬ ᏧᎾᏓᏍᏚᏗ ᏩᏯᎠ.
He works all day in the field plowing.	ᎤᏙᏓᏆᏓ ᏚᎸᏫᏍᏓᏁᎰ ᏠᎨᏏ ᎦᏓᎷᎩᏍᎬᎢ.
A little boy made a bird house for martins.	ᏡᏡ ᎤᏂᏴᏍᏗ ᎤᏬᏢᏅ ᎤᏍᏗ ᎠᏧᏣ.
I will get there about ten o'clock.	Ꮲ ᏍᎪᎢ ᎢᏳᏩᏂᎸ ᏗᏓᏥᎷᏥ.
We met somewhere down the road.	ᏫᎦᏅᏅ Ꮲ ᏥᏕᎦᏠᏒ.
Let's go swimming Sunday afternoon.	ᎢᎾᏓᏬᎡᏒ ᏙᏓᏆᏍᎬ ᏒᎯᏰᏱ ᏗᏜ.
How early do you get up on Saturday mornings?	ᎯᎳ ᎢᏏᎾᎴ ᎭᏗᏗᏍᎪ ᏙᏓᏈᏕᎾ ᏑᎾᎴᎢ?
He's returning a week from Monday.	ᏙᏓᏆᏅ ᏒᎾᏙᏓᏆᏍᏗ ᏛᎦᎷᏥ.
It's really cold outside.	ᏙᎯᏳ ᎤᏴᏜ ᏙᏱ.
Ouch! A mosquito bit me.	ᎠᏲ! ᏙᏌ ᎠᎦᏍᎦᎳ.
Ants are always working.	ᏙᏒᏓᎵ ᏂᎪᎯᎸ ᏚᏂᎸᏫᏍᏓᏁᎰᎢ.
He came from outside.	ᏙᏱ ᏓᎦᎶᎯ.
It's really cold outside, isn't it?	ᏙᏳ ᎤᏴᏜ ᏙᏱ, ᏙᎧ?
He took his family to a ball game.	ᏗᎾᎳᏍᎦᎵᏍᎬ ᏚᏘᏅᏒ ᏚᏓᏘᎿᎥᎢ.
No one likes to be confronted with a bad feeling.	Ꮭ ᎩᎶ ᎤᎸᏉᏗ ᎤᏲ ᎠᏓᏅᏓᏗᏍᏗ ᏧᏠᎯᏍᏗᎢ.
My dog's name is "Chief."	"Chief" ᏚᏙᎠ ᎩᏟ ᎠᏆᏤᎵᎢ.
He tried hard not to stagger.	ᏍᏓᏱ ᎤᏁᎵᏔᏅ ᏧᏙᎦᏙᏗ ᏂᎨᏒᎾ.
If he walks in the hot sun, he gets a rash.	ᎤᏗᏞᎩ ᎠᎦᎵᏍᎬ ᏳᏪᏙᎳ ᏚᏇᏃᏘᏍᎪᎢ.
It had horns four feet long.	ᏅᎩ ᎢᎳᏏᏗ ᎢᏗᎦᏅᎯᏓ ᏚᎷᎬᎢ.
Dust makes me sneeze.	ᎪᏍᏚ ᏓᎩᏴᏍᏙᏯᏍᏗᏍᎪᎢ.
I wonder what's causing him to vomit.	ᎦᏙᏍᎩᏂ ᎤᏍᏗ ᏄᏩᏁ ᏥᏚᎦᏍᏗᎭ.
When she's out in the sun, she wears dark glasses.	ᎠᎦᎵᏍᎬ ᏰᏙ ᏧᎵᏏᎩ ᎤᎦᏘᏅᏙᎢ.
A boy is walking around without his shoes on.	ᏂᏚᎳᏑᏢᎾ ᎠᏨᏏᏰᎠ ᎠᏧᏣ.
Cherokee Holiday is held at Tahlequah in the month of September.	ᏚᎵᏍᏗ ᎧᎸ ᎠᏂᏣᎳᎩ ᏓᎵᏆ ᎤᏂᏍᏆᎸᎡᎰ ᎤᎾᏕᏘᏱᏍᎬᎢ.
I don't like to wear gloves when I'm working.	Ꮭ ᏯᎩᎸᏉᏗ ᏗᏆᎵᏰᏑᎶᏗ ᏱᏓᎩᎸᏫᏍᏓᏁᎭ.
What color socks is he wearing?	ᎦᏙ ᎤᏍᏗ ᏧᎵᏑᏫᏓ ᏚᎵᏲᎭ?
I see a squirrel in the fork of a tree.	ᏡᎬ ᏚᎶᏥᎬ ᎤᎩᎸ ᏥᎪᏩᏘᎭ ᏌᎶᎵ.
That student works all day Saturday.	Ꮎ ᏗᏕᏠᏆᏍᎩ ᏙᏓᏈᏕᎾ ᎤᏙᏓᏆᏓ ᏚᎸᏫᏍᏓᏁᎰᎢ.
He hasn't been here since the month of October.	ᏚᏂᏂᏗ ᏥᎦᎸ ᎬᏪᏙᎸᎢ.
I hear someone making footsteps.	ᎩᎶ ᏚᏍᏓᏃᏴᎬ ᎦᏛᎩᎠ.
When he pulled the rope hard, it slipped out of my hand.	ᏍᏓᏯ ᏧᎾᏌᏁᏌ ᏍᏕᏱᏓ, ᏓᏆᏍᎦᎴᏍᏔᏅ.
Is he tired when he returns from home from work?	ᏚᏯᏪᎪᏍ ᏱᎤᎷᏣ ᏣᎸᏪᏍᏓᏁᎵᏙᎸ?
Why did you let go of the rope?	ᎦᏙᎲ ᏙᏣᏲᎯ ᏍᏕᏱᏓ?
I am telling you the truth.	ᏚᏳᎪᏛ ᎬᏃᎯᏎᎭ.
They are walking around barefoot. Is your family here?	ᏂᏚᎾᎳᏢᎾ ᎠᏁᏙᎭ. ᎠᏁᏙᎭᏍ ᏕᏣᏓᏘᎿᎥ?
I am going far away.	ᎢᎾ ᎨᎦ.
They are building a large house.	ᎡᏆ ᎦᎵᏦᏕ ᎠᎾᏁᏍᎨᎭ.
The soldiers crossed the sea in a ship.	ᏥᏳᎯ ᏚᏂᏐᏨ ᎡᏉᏂ ᎠᎾᏁᏍᎨᎭ.
He lived in Tahlequah for five years.	ᎯᏍᎩ ᏧᏕᏘᏴᏓ ᎡᎲ ᏓᎵᏆ.
Where are those ball players from?	ᎭᏢ ᎠᏁᎯ Ꮎ ᎠᎾᎳᏍᎦᎵᏍᎩ?
Indians are indigenous to America.	ᎠᏂᏴᏫᏯ ᎠᎹᏰᏟ ᎠᏁᎯᏯ.
The people were quiet while the speaker spoke.	ᎡᏝᏪ ᎨᏒ ᏴᏫ ᎦᏬᏂᏍᎩ ᎦᏬᏂᏍᎬ ᎢᎪᎯᏓ.
He's watching animals on the television.	ᎡᎿᎢ ᎠᎾᏓᏴᎳᏛᏍᎬ ᏚᎦᏙᏍᏗ.
He sat down. Did you come on foot?	ᎡᎳᏗ ᎤᎵᏍᏛᎷᏅᎢ. ᎡᎳᏗᏍ ᎯᎷᎩ?
They're coming back shortly, I think.	ᎩᎳᏊ ᏛᎠᏂᎷᏥ ᎨᎵᎠ.
That's enough!	ᎡᎵᏊ!
Can you take me to town?	ᎡᎵᏊᏍ ᏗᎦᏚᎲ ᏳᏪᏍᎩᎦᎲᎦ?
It seems like he would say where he is going.	ᎡᎵᏍᏗ ᏱᎦᏃᎲᎳ ᎤᎿ ᎡᎬᎢ.
If there was a straight road, it would have been all right.	ᎦᏥᏃᏍᏓ ᏳᏪᎦᏅᏁ ᎣᏏ ᏱᎨᏎ.
The water pipe bent, but he straightened it out.	ᎠᎹ ᎤᎶᎯᏍᏗ ᎤᏒᏙᏂ ᎤᏥᏈᏛᏁᎸ ᎠᏎᏅ ᎤᏩᏥᏃᏌᏅᎢ.
We live in a dirty world; no matter where we go we see dirt.	ᎦᏓᎭ ᎡᎶᎯ ᎢᏕᎭ; ᎭᏢᏊ ᏳᏫᎩᎷᏣ ᎦᏓ ᎢᏗᎪᏩᏘᏍᎪi.
What's that hanging on the post?	ᎦᏙ ᎤᏍᏗ Ꮎ ᏥᎦᏓᎠ ᎨᏛᎢ?
How old is that flag?	ᎯᎳ ᏄᏪᏘᏯ Ꮎ ᎦᏓᏗ?
Did you make this crock?	ᏂᎯᏍ ᏦᏢᏁ ᎯᎠ ᎦᏓᎫᎫ?
He has a pipe made of clay.	ᎦᏓᏆᎳ ᎪᏢᏔᎾ ᎦᏅᏄᏬᏩ ᎤᏩᏯ.
He didn't want to drive a dirty car, so he washed it.	Ꮭ ᏳᏚᎸᎮ ᎦᏓᎭ ᏓᏆᎴᎳ ᎤᎯᎸᏍᏗ, ᎥᏍᎩᏅ ᎢᏳᏍᏗ ᎤᏅᎦᎸᎲᎢ.
Long ago the farmers used horses for plowing the fields .	ᎪᎯᎩᏴ ᏥᎨᏎ ᏗᏂᎶᎩᏍᎩ ᏐᏈᎵ ᏓᏅᏗᏍᎨ ᏓᏂᏓᎷᎩᏍᎬ ᏠᎨᏏ.
Have you used a horse-drawn plow?	ᏨᏔᏅᎢᏍ ᏐᏈᎵ ᎤᏂᎾᏌᏁᏍᏗ ᎦᏓᎷᎪᏗ?
He picked a ripe apple to eat. Take the shirt down from the line.	ᏒᎦᏔ ᎤᏩᏂᏒ ᎤᎩᏍᏗ ᎤᏕᏒᎢ. ᎭᏓᎩ ᎠᎿᏬ ᎠᏏᎳᏛ ᏥᎦᏓᎠ.
Turn it to the left.	ᎠᎦᏍᎦᏂ ᏗᏜ ᎯᏕᏯᏍᏓ.
A broken glass cut his heel when he stepped on it while wading in water.	ᎦᏗᎨᏂ ᎤᏰᏝᎸ ᎫᎫ ᎤᏲᏨ ᎤᎳᏍᏛᏔᎾ ᎠᎹᏱ ᎠᏚᎯᏂᏙᎲᎢ.
Can you spin the wheel?	ᎡᎵᏊᏍ ᏱᏗᏆᎸᏕᏯᏍᏓ ᎦᏆᏛᎢ?
He strapped the box with some leather.	ᎦᏃᏥ ᎬᏗ ᎤᏩᏠᏢ ᎧᏁᏌᎢ.
What are you doing? Nothing much. I'm just reading a book. What's wrong with you? I'm sleepy.	ᎦᏙ ᎭᏛᏁᎭ? Ꮭ ᎤᏟ ᎢᎦ ᎪᎱᏍᏗ. ᏗᎪᏪᎵᏊ ᏕᏥᎪᎵᏰᎠ. ᎦᏙ ᏣᎵᏍᏓᏁᎭ? ᏥᎸᏍᎦ.
The policemen were standing outside when I got there.	ᏙᏱ ᏗᏜ ᏓᏂᏙᎬ ᏗᎾᏓᏂᏱᏍᎩ ᏩᎩᎷᏣ.
Children like to play on the ground.	ᏗᏂᏲᏟ ᎤᏂᎸᏉᏗ ᎦᏙᎯ ᏧᎾᏁᎶᏗᎢ.
Why didn't you come when I was calling you?	ᎦᏙᎲ ᏂᏗᏤᏅᏓ ᏧᏫᎬᏯᏂᏍᎬ?
I just feel sorry for him.	ᏥᏯᏙᎵᎦᏊ.
When he got tired of holding the coat, he dropped it.	ᏚᏯᏪᏣ ᎦᏌᎴᏂ ᎦᏁᎲ, ᎤᏙᏅᏔᏅᎢ.
The shirt fell from the line.	ᎠᏏᎳᏛ ᎦᏛ ᎠᎿᏩ ᎤᏙᏒᎢ.
Which color are you going to paint it?	ᎦᏙ ᎤᏍᏗ ᎤᎵᏑᏫᏓ ᏘᏑᏫᏍ?
What do you see? A green pencil. What do you want? I want you to help me.	ᎦᏙ ᎤᏍᏗ ᎯᎪᏩᏘᎭ? ᎢᏤ ᎢᏳᏍᏗ ᏗᎪᏪᎶᏗ. ᎦᏙ ᎤᏍᏗ ᏣᏚᎵᎭ? ᏍᎩᏍᏕᎸᏗ ᎠᏆᏚᎵ.
I have bread in the oven.	ᏗᎦᏘᏗ ᏩᎩᏝ ᎦᏚ.
The mirror is on top of the dresser.	ᏗᏎᎯᏍᏗ ᎦᏚ ᎠᏝᎭ ᎠᏓᎨᏗ.
Long ago, Cherokees helped each other through cooperative labor.	ᎪᎯᎩ ᏥᎨᏒ, ᎦᏚᎩ ᏓᎾᎵᏍᏕᎵᏍᎬ ᎠᏂᏣᎳᎩ.
What's the population of the town of Tahlequah?	ᎯᎳ ᎾᏂᎠ ᏴᏫ ᎠᏁᎭ ᏓᎵᏆ ᎦᏚᎲᎢ?
She's getting ready to bake a cake.	ᎦᏚ ᎤᎦᎾᏍᏓ ᎤᏩᏘᏗ ᎠᏛᏅᎢᏍᏗᎭ.
When the photos got wet, they were ruined.	ᏗᎦᏚᎵᏓ ᏂᏚᎵᏍᏔᎾ ᏗᏓᏟᎶᏍᏔᏅ, ᏚᏲᏨᎢ.
Forest rangers build lookout towers on hills.	ᏌᎷᏱ ᎤᎾᎦᏎᏍᏗ ᎦᏚᏏ ᏓᏁᏛᏍᎪ ᏧᎾᎦᏙᏗᎢ.
She baked a cake for her son's birthday.	ᎦᏚ ᎤᎦᎾᏍᏓ ᎤᏩᏚᏅ ᎤᏪᏥ ᎠᏧᏣ ᏚᏕᏘᏱᏍᎬᎢ.
l am hanging my shirt on the line.	ᎠᏏᎳᏛ ᎦᏛᎥᏍᎦ ᎠᏆᎿᏬ.
This boy ate five of the cucumbers.	ᎯᎠ ᎠᏧᏣ ᎯᏍᎩᎭ ᎦᎦᎹ ᏚᏍᏗᎬᎢ.
He borrowed my paddle yesterday.	ᎦᎦᏪᏍᏗ ᎠᏆᏙᎸᎡᎸ ᏒᎯ ᏥᎨᏒᎢ.
Three of them are taking turns rowing the boat.	ᏦᎢᎭ ᎢᏯᏂᎢ ᏓᎾᏓᏁᏟᏴ ᏓᏂᎦᏪᏍᎬᎢ ᏥᏳ.
The reason he is so strong is because he is always lifting heavy objects.	ᏂᎪᎯᎸ ᎦᎨᏓ ᎠᏌᎳᏓᏅᎲᏍᎬ ᏂᏗᎦᎵᏍᏙᏗ ᏥᏄᏟᏂᎬᎦ.
Who is going to drive the car?	ᎦᎩ ᏛᎯᎴᏏ ᏓᏆᎴᎠ?
Who is the man wearing the blue cap?	ᎦᎪ Ꮎ ᏌᎪᏂᎨ ᎤᎵᏍᏚᎵ ᏥᎩ ᎠᏍᎦᏯ?
The wheel went into the water when it came off.	ᎠᎹᏱ ᏭᏕᎵᏨ ᎦᏆᏘᏗ ᎤᏓᏆᏕᏍᏔᎾ.
A woodpecker is pecking on a pole.	ᎨᏛ ᎦᏆᏲᎯᎭ ᏓᎳᎳ.
He used wedges in splitting posts.	ᏗᎦᎭᏘᏗ ᏚᏭᏔᏅ ᎨᏛᏍᏗ ᏓᏍᏡᏍᎬᎢ.
What is the man putting in the can?	ᎦᏙ ᎤᏍᏗ ᎦᎵᏗ ᏔᎷᎩᏍᎩ Ꮎ ᎠᏍᎦᏯ?
Hand me the sugar bowl.	ᎧᎵᏎᏥ ᎦᎵᏙᏗ ᎡᏍᎬᏏ.
Seven days make one week.	ᎦᎵᏉᎩ ᏧᏒᎯᏓ ᏒᎾᏙᏓᏆᏍᏗ ᏂᎦᎵᏍᏗᏍᎪᎢ.
You will be the seventh.	ᏂᎯ ᎦᎵᏉᎩᏁ ᎨᏎᏍᏗ.
When he broke an arrow, he went and got another one.	ᎦᏟᏓ ᎤᏲᏍᏔᎾ, ᏄᏓᎴ ᏭᏴᎲᎢ.
Early at night he's already asleep.	ᎩᎳ ᎤᏒ ᎦᏳᎳ ᎦᏟᎰᎢ.
She's gathering hickory nuts to make kanuchi.	ᏐᎯ ᏕᎦᏟᏏᎭ ᎦᏅᏥ ᎤᏬᏢᏙᏗ.
What kind of wood do you use when you make a bow?	ᎦᏙ ᎤᏍᏗ ᎠᏓ ᎲᏗᏍᎪ ᎦᎵᏣᏗ ᏱᏦᏢᎿ?
I am going to build a house.	ᎦᎵᏦᏕ ᏓᎦᏁᏍᎨᎯ.
He's buying some metal roofing.	ᏔᎷᎩᏍᎩ ᎦᎵᏦᏛᏙᏗ ᏚᏩᏍᎦ.
When he goes fishing, he lives in a tent.	ᎠᎹᏱ ᏳᏑᏁᎾ ᎦᎵᏦᏛ ᏩᏯᎣᎢ.
He piled the gravel on the road.	ᏅᏯ ᏧᎾᏍᏗ ᎤᏩᏡᏅ ᏅᏃᎯ.
I tied up the prisoner up with a rope.	ᏍᏕᏱᏓ ᎬᏗ ᏥᏯᎸᎸ ᎠᏴᎩ.
The workers are putting some rocks in a hole in the ground.	ᏧᏂᎸᏫᏍᏓᏁᎯ ᏅᏯ ᏓᏂᏢᏍᎦ ᎦᏙᎯ ᎠᏔᎴᏒᎢ.
The children were getting sleepy; that's why we came back.	ᏗᏂᏲᏟᏛ ᏓᏂᏢᏍᎬ ᎥᏍᎩᏅ ᎢᏳᏍᏗ ᏛᎣᎦᏂᎩᏒᎢ.
Take a coat, because it's cold.	ᎦᏌᎴᏂ ᎯᏄᎦ, ᎤᏴᏜᎮᏃ.
I am holding a new shirt.	ᎢᏤ ᎠᎿᏬ ᏥᏁᎭ.
He's handling a dead snake.	ᎢᎾᏓ ᎤᎵᏬᏨ ᎦᏂᏙᎭ.
The collar on the shirt just came off.	ᎠᎿᏬ ᎦᏯᏢ ᎾᏛᎾᏕᏍᏓ
He made an extremely beautiful saddle.	ᎤᏬᏚᏨ ᎦᏯᎱᎶ ᎤᏬᏢᏅᎢ.
What is the rabbit eating?	ᎦᏙ ᎤᏍᏗ ᎦᏰᎠ ᏥᏍᏚ?
Green beans are good to eat.	ᎠᏂᏤ ᏚᏯ ᎠᏃᏍᏓ ᏗᎦᏰᏍᏗ.
He ripped an old cloth to wash the car.	ᎤᏪᏘ ᎠᎿᏬ ᎤᏩᏣᎦᎸᎲ ᏓᏆᎴᎳ ᎤᏅᎦᎸᏙᏗ.
When the cat wants to go inside the house, he scratches on the door.	ᎦᎵᏦᏕ ᎤᏴᏍᏗ ᏳᏚᎵ ᏪᏌ, ᎦᎶᎯᏍᏗ ᏕᎦᏣᎵᎪᏍᎪᎢ.
He has a fast car.	ᎦᏣᏄᎵ ᏓᏆᎴᎳ ᎤᎭ.
When I had a cold, a doctor gave me an injection.	ᎤᏴᏜ ᏣᎩᏂᏱᏍᎬ ᎠᎦᎾᎦᏘ ᎠᎩᏣᏲᏢᎢ.
I guess she's just about finished washing because she is wringing the clothes.	ᏚᎩᎶᎣᏂᏗ ᎠᏎ, ᏕᎦᏨᏩᏍᏗᎭᎮᏃ ᏗᎿᏬ.
What is the wasp stinging?	ᎦᏙ ᎤᏍᏗ ᎦᏨᏯᏍᎦ Ꮎ ᎧᎾᏥᏍᏕᏥ?
I almost brought my dog, but l left it behind.	ᎠᎴ ᎩᏟ ᏂᏓᏥᏯᏘᏄᎦ ᎠᏎᏅ ᏓᏥᏯᎧᎯᏯ.
I am giving him one cat.	ᏌᏊ ᏪᏌ ᏥᏯᎧᏁᎭ.
He bought ten bundles of young onion plants.	ᏍᎪᎯ ᏂᏕᎦᏛᎥ ᏒᎩ ᏗᎦᎪᏗ ᏚᏩᏒᎢ.
l am wrapping a Christmas gift.	ᏓᏂᏍᏓᏲᎯᎲ ᎠᏓᏁᏗ ᏥᏇᏅᏍᎦ.
He put the knife in his pocket.	ᎤᏜᏩᏛ ᎤᎳᏛ ᎭᏰᎵᏍᏗ.
He bought a new tool box.	ᎢᏤ ᎬᏔᏅᏙᏗ ᏗᎦᎳᏗᏍᏙᏗ ᎤᏩᏒᎢ
Which street do you live on?	ᎦᏙ ᎤᏍᏗ ᎦᎳᏅᏗ ᎯᏁᎳ?
He took a half dollar out of his pocket. She took some clothes out of a basket	ᎠᏰᏟ ᎤᎴᏒ ᎤᏜᏩᏛᎢ. ᏗᎿᏬ ᏚᎴᏒ ᏔᎷᏦᎯ.
When the dog chased the cat, the cat climbed a tree.	ᏪᏌ ᎤᎨᎮᎾ ᎩᏟ, ᏪᏌ ᏡᎬᎢ ᎤᎸᏒᎢ.
A blacksnake likes to eat eggs.	ᏧᏪᏥ ᏧᎩᏍᏗ ᎤᎸᏉᏗ ᎦᎴᎩ.
They pierced their ears to wear earrings.	ᏗᏂᎴᏂ ᏚᏂᏔᎴᏒᎢ ᏧᎾᏟᎠᏛᏗᎢ.
When he placed his hand on the stove, he was burned.	ᎣᏏ ᏭᏏᏔᏓ, ᎤᎴᏴᏒᎢ.
When the wind blew hard, the tree fell.	ᏍᏓᏱ ᎤᏃᎸᎾ, ᏡᎬ ᎤᎴᏴᏒᎢ.
The children are climbing around on an oak tree.	ᏧᏍᎦ ᏡᎬ ᎠᏂᎵᏙ ᏗᏂᏲᏟ.
The forest burned for three days.	ᏦᎢ ᏧᏒᎯᏓ ᎤᎵᏨ ᎢᎾᎨᎢ.
He's in the garden picking corn.	ᏠᎨᏏ ᏪᏙᎭ ᏎᎷ ᏫᏗᎦᎵᎭ.
When a dog was run over by a car, it died.	ᏓᏆᎴᎳ ᎤᏗᏅᏔᎾ ᎩᏟ, ᎤᎵᏬᏨᎢ.
The fat man is trying to lose weight.	Ꮎ ᎦᎵᏦᎯᏓ ᎠᏍᎦᏯ ᎠᏁᎵᏗ ᎤᏓᎨᏒ ᎤᏲᎱᏎᏗᎢ.
He spanked his son.	ᎤᏪᏥ ᎠᏧᏣ ᎤᎵᎥᏂᎸᎢ.
He hoes his garden every day.	ᏧᏙᏓᏋᏓ ᎦᎶᎩᏍᎪ ᎤᏫᏒᏅᎢ.
Where did you put the hoe?	ᎭᏢ ᏣᏕ ᎦᎶᎪᏗ?
He is cleaning a gun.	ᎦᎶᏇ ᎦᏅᎦᎵᎭ.
My neighbor stopped by on his way to the store	ᎾᎥ ᎢᏦᎩᎾᏓᎵ ᎤᎶᎯᏍᏔᏅ ᏗᏓᎾᏅ ᏩᎦᏘ.
He went through the doorway.	ᎪᎶᎯᏍᏗ ᏭᎦᏛᎴᏒ.
He tried to overtake me, but I was walking to fast.	ᎠᎩᎶᎯᏎᏗ ᎤᏁᎵᏔᏅ ᎠᏎᏅ ᎦᏣᏄᎵ ᎦᎢᏒᎢ.
His birthday is in August	ᎦᎶᏂ ᎧᎸ ᎤᏕᏘᏱᏍᎩ.
Whenever someone is not alert, he tricks him.	ᏄᎦᏎᏍᏛᎾ Ᏹgi ᎩᎶ ᎦᎶᏂᏍᏗᏍᎪᎢ.
I was going to oil the sewing machine, but she had already oiled it.	ᏙᏓᏥᎶᏁᎢᏒ ᎦᏰᏫᏍᎩ ᎠᏎᏅ ᎦᏳᎳ ᏧᎶᏁᏓ ᎦᏒᎢ.
Knock the bug off the potato.	ᎯᎶᏅᏓ ᏥᎪᏯ ᏄᏅ ᏧᎩᎳ.
Whenever he thinks he can get away with it, he cheats.	ᏁᎳᎩ ᏱᎬᏩᏛᏅᏗ ᏰᎵᎠ, ᎦᎶᏄᎮᏍᎪᎢ.
He passed by us without even saying anything. He passed easily when he was tested.	ᎪᏍᏗ ᏄᏛᏅᎾ ᎤᎶᏒ ᎣᏥᏙᎾᎥ ᎾᎥᎢ. ᎠᎯᏓ ᎤᎶᏒ ᎠᏥᎪᎵᏰᎠ.
He almost fell.	ᎠᎴ ᏄᎶᏒᎢ.
He arrives at five o' clock	ᎯᏍᎩ ᎢᏳᏩᏂᎸ ᎦᎷᎪᎢ.
Why didn't they start? Was there something missing?	ᎦᏙ ᏄᎾᎴᏅᎲᎾ? ᎪᎱᏍᏗᏍ ᎦᎷᎶᎨ?
He used an axe to fell the tree.	ᎦᎷᏯᏍᏗ ᎤᏮᏔᏅ ᎤᎴᏴᏍᏔᏅ ᏡᎬᎢ.
If you don't keep the mattresses clean, bed bugs will get on them. 	ᏧᏓᏅᎦᎸᏓ ᏂᏙᏩᏅᎾ ᏱᎩ ᏗᏤᏍᏙ ᎦᎷᏯᏍᏗ ᏯᎾᎩᎸᎥᎦ.
He is chopping on a big tree.	ᎤᏔᎾ ᏡᎬᎢ ᎦᎷᏯᏍᎦ.
Where is the laundry basket?	ᎭᏢ ᏗᎦᏓᎭ ᏗᎿᏩ ᏗᎦᎸᏙᏗ?
Did you beat him up when you two fought?	ᎯᎸᏂᎴᎢᏍ ᏥᏍᏓᏟᎸ?
Is heaven high in the sky?	ᎦᎸᎳᏗᏍ ᎦᎸᎶ ᎦᎸᎳᏗ?
The airplane is flying high. 	ᏥᏳ ᎦᎸᎳᏗ ᎦᏃᎯᎵ.
The ball flew above your head.	ᎯᏍᎪᎵ ᎦᎸᎳᏗᏜ ᎦᏃᎯᎸᏍᎦ ᏍᏆᏞᏍᏗ.
Climb up higher.	ᎦᎸᎳᏗᎨ ᏫᎶᎦ.
The Sky is blue.	ᎦᎸᎶ ᏌᎪᏂᎨᎢ.
He put the dead snake in a hole in the ground	ᎦᏙᎯ ᎠᏔᎴᏒ ᎤᎸᏅ ᎢᎾᏓ ᎤᎵᏬᏨᎢ.
Hurry! Let's get there before he sells the house.	ᏄᎳ! ᏄᎾᏗᏅᏓᏊ ᎦᎵᏦᏕ ᏫᏂᏧᏨᎢ.
He has a lot of livestock on his place.	ᏥᏍᏈᏍᏗ ᎦᎾᏝᎢ ᎤᏴᏗᏓᎾ ᎤᏤᎵᎪᎯ.
I'm hiring him for as long as he wants to work.	ᎤᏚᎵᏍᎬ ᎢᎪᎯᏓ ᏧᎸᏫᏍᏓᏁᏗ ᏥᎾᏢᏍᎦ.
Who is that lazy man?	ᎦᎪ Ꮎ ᎦᎾᎵ ᎠᏍᎦᏯ?
This is a gelding.	ᎯᎠ ᏐᏈᎵ ᎦᎾᎵ.
Where did you find the belt?	ᎠᏢ ᏣᎾᏩᏛᎮ Ꮎ ᎠᏓᎶᏍᏗ?
Are you going to take a coat?	ᎦᏌᎴᏂᏍ ᏘᎾᏫᏛᎯ?
He has a dangerous job.	ᎦᎾᏰᎩ ᏧᎸᏫᏍᏓᏁᏗ ᎤᎭ.
Where did you get your cap?	ᎭᏢ ᏣᏁᏎ ᏣᎵᏍᏚᎶ?
I am changing the wheel.	ᎦᏆᏛ ᏥᏁᏟᏴᎠ.
He has a shirt made of deer skin.	ᎠᏫ ᎦᏁᎦ ᎪᏢᏔᏅ ᎠᎿᏩ ᎤᎾᎠ.
Take three bats to the baseball diamond.	ᏦᎢᎭ ᏗᎪᏍᏛᏂᏍᏗ ᏘᏄᎦ ᎤᎾᎳᏍᎦᎵᏗᎢ.
He likes cucumbers so well, he eats them without peeling them.	ᏂᏚᏁᎦᎳᎸᏓᏊ ᏓᏍᏗᎩᏍᎪ ᎦᎦᎹ ᎢᎦ ᏧᎸᏉᏗ.
She got a gallon of milk.	ᏑᏟᎶᏓ ᎢᎦ ᎤᏅᏗ ᎤᏁᎩᏒᎢ.
He's milking a cow.	ᎤᏅᏗ ᎦᏁᎩᎡᎭ ᏩᎦ.
Did you find out who was bewitching you?	ᏣᏕᎶᎰᏎᎢᏍ ᎤᏍᎩᎾ ᏣᏁᎫᏗᏍᎬ?
He is holding a 20-guage shotgun.	ᏔᎳᏍᎪ ᎠᏃᏪᎵ ᎤᏒᏕᎾ ᎦᎶᏇ ᎦᏁᎭ.
How much milk did you leave?	ᎯᎳ ᎢᎦ ᎤᏅᏗ ᏣᏁᎯᏰᎢ?
I just gave him water to drink.	ᎠᎹ ᎤᏗᏔᏍᏗ ᏥᏁᎥᏏ.
The dog is trying to find some water.	Ꮎ ᎩᏟ ᎠᎹ ᎤᏁᏩᏛᏗ ᎠᏁᎯᏗᎭ.
He took some water to the workers.	ᏧᏂᎸᏫᏍᏓᏁᎯ ᎤᎾᏗᏔᏍᏗ ᎠᎹ ᎤᏁᏫᏛᎲᎢ.
A ball hit him on his chest.	ᎦᏁᏥ ᎤᏩᏂᎸ ᏍᏆᏞᏍᏗ.
He lives in a new house.	ᎢᏤ ᎠᏓᏁᎸ ᎦᏁᎳ.
Is your friend married?	ᎦᏁᎵᏍ ᏍᏓᎵᎢ?
The roads are freezing.	ᏕᎦᎾᏅ ᏕᎦᏁᏍᏓᎳᏗᎠ.
One year ago today it hailed hard.	ᏚᏕᏘᏴᏌ ᏥᎨᏒ ᎪᎯ ᎢᎦ ᏍᏓᏯ ᎤᏁᏐᏯᏒᎢ.
A carpenter always uses a saw when building houses.	ᏗᏁᏍᎨᏍᎩ ᏂᎪᎯᎸ ᎦᏅᏙᎩ ᎬᏗᏍᎪ ᏓᏁᏍᎨᏍᎬᎢ.
He always brushes his teeth after every meal.	ᏂᎪᎯᎸ ᏳᎵᏍᏓᏴᏃᎿ ᏕᎦᏅᎦᎵᏍᎪᎢ ᏕᎦᏅᏙᎬᎢ.
I'll just lie on the floor.	ᎡᎳᏗᏊ ᏥᏅᎨᏍᏗ.
He burned his tongue drinking hot coffee.	ᎦᏅᎪ ᎦᎴᏴᎯ ᎧᏫ ᎤᏗᏞᎩ ᎠᏗᏔᏍᎬᎢ.
When he stepped into the swimming pool he agitated the water.	ᎠᏓᏬᏍᏗ ᎤᏚᎿ ᎤᏅᏆᎡᎲ ᎠᎹ.
I am taking some drinking water for the workers.	ᏧᏂᎸᏫᏍᏓᏁ ᎤᎾᏗᏔᏍᏗ ᎠᎹ ᏥᏅᏤᎦ.
I have five gallons of milk	ᎯᏍᎩ ᎢᏳᏟᎶᏓ ᎤᏅᏗ ᏥᏅᏤᎭ.
He's handling some poison.	ᏅᏬᏘ ᎠᏗᎯᎯ ᎦᏅᏥᏙᎭ.
Where did the salesman go?	ᎭᏢ ᏫᎦᎶᎯ Ꮎ ᎦᏅᏔᏂᏙᎯ?
A bullet hit him in his shoulder.	ᎦᏂ ᎤᏩᏂᎸ ᎦᏅᏬᎢ.
The dog is trying to catch his tail.	ᎦᏂᏓᏛ ᎤᏂᏱᏗ ᎠᏁᎵᏗᎭ ᎩᏟ.
Who had the bat last?	ᎦᎪ ᎣᏂ ᎤᏩᏂᏙᎴ ᎪᏍᏛᏂᏍᏗ?
I don't hate anyone.	Ꮭ ᎩᎶ ᏱᏥᏂᏆᏘᎰᎢ.
Where shall I set up the bed?	ᎭᏢ ᎢᏴ ᏓᏥᏂᏝᏗ?
She has a bedstead that belonged to her mother.	ᎤᏥ ᎤᏤᎵ ᎢᏳᎵᏍᏔᏅ ᎦᏂᏝᏗᏍᏗ ᎤᏩᏯ.
The man is going to buy a bed.	Ꮎ ᎠᏍᎦᏯ ᎦᏂᏟ ᏓᏳᏩᏏ.
When the chief spoke, he urged the people to work together.	ᎤᎬᏫᏳᎯ ᎤᏬᏂᏌ, ᏚᏂᎳᏕᎸ ᏴᏫ ᏧᎾᎵᏍᏕᎸᏗ
He buried a dead snake	ᎢᎾᏓ ᎤᎵᏬᏨ ᎤᏂᏓᏅᎢ.
He left his shirt when he escaped from jail.	ᏧᎾᏓᏍᏚᏗ ᎤᎵᏘᏌ ᎤᏂᏯᏍᏔᏅᎢ.
Catch the dog. When was he arrested?	Ꮎ ᎩᏟ ᎯᏂᏯ. ᎯᎳᏴ ᏥᎨᏒ ᎠᏥᏂᏴᎮ?
He wants to become a catcher.	ᎦᏂᏱᏍᎩ ᎢᏳᎵᏍᏙᏏ ᎤᏚᎵᎭ.
He hunts all the time in the winter.	ᎪᎳ ᏱᎩ ᏂᎪᎯᎸ ᎦᏃᎭᎵᏙᎰᎢ.
A hunter is going across a field.	ᎦᏃᎭᎵᏙᎯ ᏂᏚᎾᏗᏫᏍᏗ ᏠᎨᏏ.
An airplane just flew by.	ᏥᏳ ᎦᏃᎯᎸᏍᏓ.
Sometimes spring creek floods.	ᏴᏓᎭ ᏥᏍᏛᏃᏱ ᎤᏪᏴ ᎦᏃᎱᎩᏍᎪᎢ.
When he rang the bell, church services started.	ᎤᎭᎸᏂ ᎤᏃᏴᏟᏍᏔᎾ ᏓᏂᎳᏫᎬ ᎤᏓᎴᏅᎲᎢ.
He wants some leather to make belts.	ᏗᏓᏠᏍᏗ ᏧᏬᏢᏙᏗ ᎦᏃᏥ ᎤᏚᎵᎭ.
Cool winds blow in the evening.	ᎤᏁᏌᏴᏜ ᎦᏃᎸᎥᏍᎪ ᏒᎯᏰᏱ.
He's in jail for stealing a car.	ᏓᏆᎴᎳ ᎤᏃᏍᎩᏒ ᎢᏳᏍᏗ ᏧᎾᏓᏍᎫᎩ ᏩᏯᎠ.
I don't want to buy anything that has been stolen.	Ꮭ ᏯᏆᏚᎵ ᎪᎱᏍᏗ ᎦᏃᏍᎩᏓ ᎠᎩᏩᎯᏍᏗᎢ.
A thief was caught stealing.	ᎦᏃᏍᎩᏍᎩ ᎠᏥᏩᏛᏔᏅ ᎦᏃᏍᎩᏍᎬᎢ.
1. The boat is sinking. 2. When will he be buried?	1. ᏥᏳ ᎦᏃᏴᎦ. 2. ᎯᎳ ᎢᏴ ᎦᏃᏴᎨᏍᏗ?
Can you pull a car for me?	ᎡᎵᏊᏍ ᏓᏆᎴᎳ ᏱᏍᎩᎾᏌᏁᏏ?
Throw that stick away.	ᎤᏟ ᏫᏣᏚᎦ Ꮎ ᎦᏲᏍᏓ.
Let me drag it for awhile.	ᎠᏴ ᏥᎾᏏᏄᎦ ᏞᎦ.
When it got hot inside, I went out.	ᎤᎵᏞᎲᏌ ᎦᎵᏦᏕ ᏗᏜ, ᎠᎩᎤᎪᏨᎢ.
We get our drinking water from a spring.	ᎦᏄᎪᎬ ᏙᏥᎬᎩᏍᎪ ᎠᎹ ᎣᎦᏗᏔᏍᏗ.
Can you tell me where the exit is?	ᎡᎵᏊᏍ ᏱᏍᎩᏃᎯᏍ ᎤᎿ ᎪᏢᏒ ᎦᏄᎪᎢᏍᏙᏗᎢ?
He is mowing the grass.	ᎦᏄᎸ ᎠᎦᎵᏍᎦ.
He's repairing a lawn mower.	ᎦᏄᎸ ᎠᎦᎵᏍᏗ ᎠᎦᎵᏍᎦ.
The strong man is twisting steel.	Ꮎ ᎤᏟᏂᎩᏓ ᎠᏍᎦᏯ ᏔᎷᎩᏍᎩ ᎦᏄᏖᏲᎭ.
He fired about ten times, but he missed the target over and over.	Ꮲ ᏍᎪᎢ ᎢᏳᏩᎦᏗ ᏂᏚᏌᏎᏅ ᎠᏎᏅ ᏚᏅᏗᏍᎢᎶᎥ ᎠᎪᏂᏍᎬᎢ.
She's feeding a baby on her breast.	ᎦᏅᏗ ᎠᏍᏛᎥᏍᎦ ᎤᏍᏗᎢ.
He fell hard playing ball.	ᏍᏓᏱ ᎤᏅᏨ ᎠᎳᏍᎦᎵᏍᎩᎥᎢ.
I'm cleaning my fingernails.	ᏓᏆᏑᎦᏢ ᏕᏥᏅᎦᎵᎠ.
He's hammering on a nail.	ᏴᎩ ᎦᎭᏛ ᏓᏅᏆᎶᎠ.
A hammer is a carpenter's tool.	ᎦᏅᏆᎶᏍᏗ ᏥᎩ ᏗᏁᏍᎨᏍᎩ ᎤᏮᏔᏂᏓᏍᏗ.
They fix horseshoes at a blacksmith shop.	ᎦᏅᏆᎶᏍᎩᎢ ᎣᏍᏓ ᏂᏓᏅᏁᎰ ᏐᏈᎵ ᏧᎾᎳᏍᏑᎶ.
Mountain climbers carry long ropes.	ᎣᏓᎸ ᎠᏂᎴᎩ ᏗᎦᏅᎯᏓ ᏍᏕᏱᏓ ᏓᏂᏁᎰᎢ.
When he roped the calf, he tied up its legs. Put your brakes on!	ᏩᎦ ᎠᎩᎾ ᎤᏍᎳᏓ ᏚᏅᏠᏢᎢ. ᏘᏅᏠᎦ!
Pull the brake! He ran out of brakes.	ᎦᏅᏠᏍᏗ ᏫᎾᏌᎾᎩ. ᏗᎦᏅᏠᏍᏗ ᏚᏨᏁᎸᎢ.
I live near highway 33.	ᏦᏍᎪ ᏦᎢ ᎪᏪᎵ ᎦᏅᏅ ᎾᎥ ᏥᏁᎳ.
He tossed about all night.	ᎤᎵᏨᏓᏆᏓ ᎤᏅᏥᏙᎸᎢ.
I gave him a new shirt.	ᎢᏤ ᎠᎿᏬ ᏥᏅᏁᎸᎢ.
My grandfather used to smoke a corncob pipe.	ᏎᎷ ᎤᏓ ᎪᏢᏔᏅ ᎦᏅᏃᏩ ᎪᎦᏍᏗᏍᎩ ᎨᏒᎢ ᎡᏚᏚ.
He's eating a turkey leg.	ᎬᎾ ᎦᏅᏍᎨ ᎠᏍᏗᎩᎠ.
He was shot in his leg in a war, and it had to be amputated.	ᎦᏅᏍᎨᏂ ᎤᏩᏌᏙᏴ ᏍᏆᏞᏍᏗ.
His shoulder hurts from throwing the ball hard.	ᎦᏅᏬ ᎤᏪᏍᏓᏁ ᎠᏍᏓᏴ ᎤᏗᏅᏒ ᏍᏆᏞᏍᏗ.
He pushed the car for a mile before it started.	ᏑᏟᎶᏓ ᎢᏳᏓᏅᎯᏓ ᎤᏩᏌᏙᏴ ᏓᏆᎴᎳ ᎩᎳ ᎤᏂᎩᏒᎢ.
He uses all his strength when he rolls the big wheel.	ᏄᏟᏂᎬᎬ ᎬᏗᏍᎪ ᏳᏩᏌᏆᎴᏝ Ꮎ ᎤᏔᎾ ᎦᏆᏘᏗ.
They have a round dinner table at home.	ᎦᏌᏆᎸ ᎦᏍᎩᎶ ᎠᎵᏍᏓᏴᏗ ᎤᏂᏍᎩᎳ ᏧᏁᏅᏒᎢ.
Put on a coat when you go outside.	ᎦᏌᎴᏂ ᎭᎿᏬᎥ ᏙᏱ ᎮᏒᎢ.
The fire started at the roof when the house burned.	ᎦᏌᎾᎵ ᏓᏳᎴᏅᎲ ᎠᏓᏪᎳᎩᏍᎬ Ꮎ ᎦᎵᏦᏕ ᏧᎪᏅᎢ.
She's threading a needle. The old car left a trail of smoke as it took off.	ᎠᏍᏘ ᎦᏌᏁᎾᏛᏍᎦ ᏴᎩᎢ. ᏧᎦᏒᏍᏗ ᎤᏩᏌᏁᎾᏛᏅ ᎤᏪᏘ ᏓᏆᎴᎳ ᎤᏓᎾᏫᏍᏔᎾ.
Set up twenty chairs.	ᏔᎵᏍᎪ ᏗᎦᏍᎩᎶ ᏗᏥᏍᎩᎳᏓ.
She's looking for a new dining table.	ᎢᏤ ᎦᏍᎩᎶ ᎠᎵᏍᏓᏴᏗ ᎤᏲᎭ.
My uncle made a rocking chair.	ᎠᏍᎩᎶ ᎯᏟᎨᏍᎩ ᎤᏬᏢᏅ ᎡᏚᎢ.
That cat is always sleeping on a chair.	ᏂᎪᎯᎸ ᎦᏍᎩᎸ ᎦᏟᎰ Ꮎ ᏪᏌ.
Water is dripping from the wet cloth hanging on a line.	ᎠᎹ ᎦᏍᏆᎣᎢᎭ Ꮎ ᎦᏚᎵᏓ ᎠᎿᏬ ᏥᎦᏓ ᎠᏏᎳᏛᎢ.
He became humpbacked because he wouldn't sit up straight.	ᎦᏥᏃᏍᏓ ᎾᎵᏍᏛᏡᏍᎬᎾ ᎨᏒ ᎢᏳᏍᏗ ᎦᏐᏆᏘ ᏄᎵᏍᏔᏅᎢ.
The man's back hurts.	Ꮎ ᎠᏍᎦᏯ ᎦᏐᎯ ᎤᏪᏍᏓᏁᎭ.
When the dog heard someone whistling, he took off running.	ᎩᎶ ᎦᏒᏂᎬ ᎤᏛᎦᎾ, ᎩᏟ ᎤᏓᎾᏩᏍᏔᏅᎢ.
He's piling up rocks he picked up in the field.	ᏠᎨᏏ ᏧᏭᏖᏓ ᏅᏯ ᎦᏒᏛᏍᎦ.
An electric light is hanging from a pole.	ᎨᏛ ᎦᏔ ᎠᎾᎦᎵᏍᎩ ᎠᏨᏍᏗ.
He lost a button from his shirt.	ᎦᏘᏗ ᎤᏲᎱᏏ ᎤᎿᏬᎩᎢ.
The cook is looking for a cooking pan.	ᎦᏖᏍᏗ ᎤᏲᎭ ᏗᏓᏍᏓᏴᎲᏍᎩ.
He was stabbed over and over with a knife.	ᎭᏰᎵᏍᏗ ᎬᏗ ᏓᏥᏘᏏᎶᎥᎢ.
They prohibit drinking at the stompgrounds.	ᎠᏓᏴᏍᏕᏍᏗᏍᎩ ᎠᏗᏔᏍᏗ ᎤᏂᏅᏍᏙ ᎠᏘᏲᎢ.
There is a squirrel tail hanging on a pole.	ᏌᎶᎵ ᎦᏙᎦ ᎦᏓᎠ ᎨᏛᎢ.
She's hanging up a picture.	ᏗᏓᏟᎶᏍᏔᏅ ᎦᏛᏍᎦ.
He really likes to joke.	ᏙᎯᏳ ᎤᎸᏉᏗ ᎤᏪᏢᏗ.
When he drives the cattle for a long distance he rests them a few times.	ᎢᎾ ᏱᏚᎯᎴᎾ ᏩᎦ ᎢᎸᏍᎩ ᎢᏳᏩᎦᏗ ᏕᎦᏪᏐᎸᏍᏗᏍᎪᎢ.
If the dog has fleas, he bathes it. He baptized ten people.	ᏧᎦ ᏱᎬᏩᎳ ᎩᏟ ᎦᏬᏍᎪᎢ. ᏍᎪᎯ ᎢᏯᏂᎢ ᏴᏫ ᏚᏬᎥᎢ.
When you're asked a question, answer.	ᎪᎱᏍᏗ ᎡᏣᏛᏛᏅ, ᎭᏬᎯᎵᏴᏒᎢ.
Because his son is so mean, he always lectures him.	ᎤᏁᎫᏨ ᎢᏳᏍᏗ ᎤᏪᏥ ᎠᏧᏣ ᏂᎪᎯᎸ ᎦᏬᏅᏗᏍᎪᎢ.
Don't be listening to gossip.	ᏞᏍᏗ ᎦᏬᏂᎭ ᏯᏛᏓᏍᏗᎨᏍᏗ.
He's talking a lot, but he's not saying anything.	ᏥᏈᏍᏗ ᎦᏬᏂᎭ, ᎠᏎᏅ Ꮭ ᎪᎱᏍᏗ ᏯᏗᎭ.
The man raises large cantaloupes.	Ꮎ ᎠᏍᎪᏯ ᏧᎾᏔᎾ ᎠᏂᏫᏒᎩ ᏓᏛᎯᏍᏗᏍᎪᎢ.
A wasp stung him on his finger.	gᎠᏰᏌᏛ ᎤᏩᏨᏴ ᎧᎾᏥᏍᏕᏥ
She's sewing a dress with a sewing machine.	gᎦᏰᏫᏍᎩ ᎬᏗ ᎦᏰᏫᏍᎦ ᎠᏌᏃ.
She wants an electric sewing machine.	ᎠᎾᎦᎵᏍᎩ ᎤᏂᎩᏍᏗᏍᎩ ᎦᏰᏫᏍᎩ ᎤᏚᎵᎭ.
If someone is a liar, they say he has a forked tongue.	ᎩᎶ ᎦᏴᎪᎩ ᏱᎩ, ᏣᎶᏥᎩ ᎦᏅᏓᏓ ᎠᎾᏗᏍᎪᎢ.
He goes around telling lies.	ᎦᏴᎪᎩ ᎧᏃᎮᏟᏙᎰᎢ.
Pour me a little coffee.	ᎦᏲᏟ ᎧᏫ ᏍᎩᏟᏍᏓᏏ.
Have you already been to town?	ᎦᏳᎳᏍ Ꮻ\ᏤᏙᎳ ᏗᎦᏚᎲᎢ?
The dog is hungry. Feed it.	ᎩᏟ ᎤᏲᏏᎭ. ᎯᏰᎶᎦ.
The dog howls when he hears the wolves. When their team won, the ballplayers yelled.	ᏩᏯ ᏱᏚᏛᎦᎾ ᎩᏟ ᎨᏢᎲᏍᎪᎢ. ᎤᎾᎵᎪᏒ ᎤᎾᏓᏠᏌ, ᎤᏁᏡᏅ ᎠᎾᎳᏍᎦᎵᏍᎩ.
Have you ever tried to rope a wild horse?	ᏣᏁᎵᏔᏅᎢᏍ ᏍᏈᎵ ᎨᏯᏔᎯ ᎯᏴᏍᎳᏗᏍᏗᎢ?
I saw him walking downstream while ago.	ᎨᎢ ᏗᏜ ᏩᎢᏒ ᏣᏫᏣᎪᎥ ᎪᎯᎢ.
She has to go to the clinic tomorrow.	ᎨᏥᎪᎵᏰᏗ ᏭᏪᏍᏓᏍᏗ ᏑᎾᎴᎢ.
He's leading a small dog by a leash.	ᎤᏍᏗ ᎩᏟ ᎨᎵᏏᏁᎭ.
How much are the pies?	ᎯᎳ ᏣᎬᏩᎶᏗ ᏗᎨᎵᏍᏘᎩ.
When he digs holes in a rocky place, he uses a crowbar.	ᏅᏲᎯ ᏱᏓᏍᎪᏍᎦ ᎨᏘᎶᏍᏗ ᎬᏗᏍᎪᎢ.
Who buys posts?	ᎦᎪ ᏚᏩᏍᎪ ᏗᎨᏛᏏᏗ?
Set the post here in the center.	ᎠᎭᏂ ᎠᏰᏟ ᎮᏛᎦ.
There's blood on your shirt.	ᎩᎦ ᎤᏓᏅᎵᏰᎠ ᏣᏄᏮᎢ.
When a ball hit him on his nose, he got a nosebleed.	ᏍᏆᏞᏍᏗ ᎤᏩᏂᎳ ᎧᏴᏐᎵ ᎩᎦ ᏚᏴᏍᏉᎸᎢ.
Red is my favorite color.	ᎩᎦᎨ ᎤᎵᏑᏫᏓ ᏩᎩᎸᏉᏛᎢ.
There's some loose hair on your shirt.	ᎩᏝ ᏄᏍᏗ ᏣᏄᏮᎢ.
I see a mean dog.	ᎩᏟ ᎤᎾᎸᎯ ᏥᎪᏩᏘᎭ.
I hear a hounddog barking.	ᎩᏟ ᏗᎦᎴᏅᎯᏓ ᏓᏑᏪᏍᎬ ᎦᏛᎩᎠ.
This is how it is written in English.	ᎯᎠ ᏂᎬᎿ ᎩᎵᏏ ᎪᏪᎸᎢ.
Lend me a quarter.	ᎩᏄᏘᏗ ᏍᎩᏙᎵᏍᏓ.
She's going to quit teaching next spring.	ᏐᎢ ᎪᎨᏱ ᎢᏴ ᏛᏑᎵᎪᏥ ᏓᏕᏲᎲᏍᎬᎢ.
I can't wait till summer.	ᎠᏋᏅᎦ ᎪᎩ ᎢᏳᎵᏍᏙᏗᎢ.
Did he take a long time building the house?	ᎪᎯᏓᏍ ᎤᎯᎶᏙᎴ ᎦᎵᏦᏕ ᎠᏁᏍᎨᏍᎬᎢ?
He holds his son's hand when they cross the water.	ᎪᎣᎯᏁᎪ ᎤᏪᏥ ᎠᏧᏣ ᎠᎹᏱ ᏱᏚᏂᏐᏣ.
I agree with what he says. I want you to vouch for me.	ᏥᏲᎢᏴᏓᏁ ᏂᎦᏪᏍᎬᏒᎢ. ᏍᏉᎯᏴᏓᏁᏗ ᎠᏆᏚᎵᎭ.
He has a lot of faith.	ᏥᏈᏍᏗ ᎪᎯᏴᏗ ᎤᏪᎭ.
Even if it's been ten years since he has seen someone, he recognizes him easily.	ᎥᏍᏊ ᏍᎪᎯ ᎾᏕᏘᏯ ᎬᏩᎪᎲ ᏱᎩ ᎩᎶ, ᎠᎯᏓ ᎪᎵᎪᎢ.
Does he understand Cherokee?	ᎪᎵᎦᏍ ᏣᎳᎩ?
Do you know this man?	ᎯᏲᎵᎩᏍ ᎯᎠ ᎠᏍᎦᏯ?
Pass me some butter.	ᎪᏢᏅ ᎡᏍᎩᏕᎳ
If he eats just a little, he gets full.	ᎦᏲᏟᏊ ᏳᎵᏍᏓᏴᎾ, ᏢᏍᎪᎢ
What are you making?	ᎦᏙ ᎤᏍᏗ ᎰᏢᏍᎦ?
He accidently dropped the clock from the table.	ᎦᏍᎩᎸ ᏝᎲ ᏩᏣ ᎤᏬᎰᏅᏙᏔᏅᎢ
The window pane fell.	ᏦᎳᏂ ᎦᏘᏅᏛ ᎤᏬᎰᏒᎢ.
They are looking for something, but I don't know what it is.	ᎪᎱᏍᏗ ᎤᏂᏲ ᎠᏎᏅ Ꮭ ᏯᏆᎾᏔ ᎢᏳᏍᏗ ᎨᏒᎢ.
They ordered some writing tablets.	ᎪᏪᎵ ᏗᎪᏪᎶᏗ ᏚᎾᏓᏅᏒᎢ.
Whose letter are you writing?	ᎦᎪ ᎤᏁᏍᏗ ᎪᏪᎵ ᎰᏪᎵᎠ?
A lot of Cherokee students go to school at Greasy School.	ᎤᏂᎪᏗ ᎠᏂᏣᎳᎩ ᏗᎾᏕᏠᏆᏍᎩ ᏓᎾᏕᏠᏆᏍᎪ ᎪᎢ ᏧᎾᏕᏠᏆᏍᏗ.
Sausage makes a lot of grease.	ᏏᏆ ᎭᏫᏯ ᏥᏈᏍᏗ ᎪᎢ ᎠᏙᏢᎾᏗᏍᎪᎢ.
He is eating greasy meat.	ᎪᎢᎭ ᎭᏫᏯ ᎠᎩᎠ.
Which finger do you use when you pull the trigger?	ᎦᏙ ᎤᏍᏗ ᎯᏰᏌᏛ ᎲᏗᏍᎪ ᏱᏦᏣᏁᏌ?
He's oiling the trigger so it won't rust.	ᎤᏯᏍᏜᏗᏍᏗ ᏂᎨᏒᎾ ᎤᏰᎸᏒ ᎪᏣᏁᏍᏗ ᎦᎶᏁᎠ.
There are twenty cigarettes in one package.	ᏔᏍᎵᏍᎪᎯ ᏗᎪᎦᏍᎩ ᏕᎦᎶ ᏌᏊ ᏂᏕᎦᏇᏅᏒᎢ.
He smokes two packages of cegarettes in one day.	ᏔᎵ ᏂᏕᎦᎳᏗᏍᏛ ᏗᎪᎦᏍᏗ ᏕᎪᎦᏍᎪᎢ ᏏᎦ.
Do you like winter?	ᏣᎸᏉᏗᏍ ᎪᎳ?
The doctor has pneumonia.	ᎪᎴᎯ ᎤᏢᎦ ᎦᎾᎦᏘ.
When I sharpened the axe with a file, it became sharp.	ᎠᏥᎳ ᎤᏥᎦᏘ ᎬᏗ ᎠᎩᏢᎦᎭ ᎦᎷᏯᏍᏗ ᎪᏍᏓᏱ ᏄᎵᏍᏔᏅᎢ.
He was using a dull axe to chop wood.	ᎪᏍᏗᏳᏟ ᎦᎷᏯᏍᏗ ᎬᏗᏍᎬ ᎠᏓ ᏓᏍᏆᎵᏍᎬᎢ.
They lost the ball when he batted.	ᏍᏆᏞᏍᏗ ᎤᏂᏲᎱᏎᎸ ᎤᏬᏍᏛᏂᎳ.
How many bats did you bring?	ᎯᎳ ᎢᎦ ᏗᎪᏍᏛᏂᏍᏗ ᏕᎯᏃᎦ?
Tell him I said hello when you seehim.	ᏏᏲ ᎠᏗᎭ ᎯᏲᏎᎸ ᎯᎪᎥᎢ.
His leg swelled where a snake bit him.	ᎢᎾᏓ ᎤᏍᎦᎵᏨ ᎦᏅᏍᎨᏂ ᎤᏬᏘᏒᎢ.
Let's sit by the fire.	ᎪᏛ ᎾᎤ ᏕᎩᏃᏞᏍᏗ.
Last night l built a big fire .	ᎤᏒ ᏥᎨᏒ ᎤᏔᎾ ᎠᎪᏔᏅᎢ.
Unhitch the horse and let him graze. He unhooked the chain when the car started. He unplugs the television when it's lightening.	ᎯᏳᏓᎳᎩ ᏐᏈᎵ ᎤᏁᎳᎩ ᏩᎵᏍᏓᏴᏂᏓ. ᎤᏂᎩᏌ ᏓᏆᎴᎳ ᎤᏭᏓᎴᏒ ᎤᎾᏓᏕᏒᏓ. ᎠᏓᏴᎳᏛᏍᎩ ᎫᏓᎴᏍᎪ ᏯᎾᎦᎵᎠ.
He hitched up his horse at the hitching post. Did he hook up the battery?	ᏐᏈᎵ ᎤᎾᏚᏓᎸᏗ ᎤᏩᏓᎸᏅ ᏐᏈᎵ ᎤᏣᎵᎢ. ᏕᎫᏓᎸᎢᎦᏍ ᎠᎾᎦᎵᏍᎩ?
These bottles contain milk.	ᎯᎠ ᎫᎫ ᎤᏅᏗ ᏓᏟᏍᏗ.
Ticks are making the dog itch.	 ᎫᎫ ᏕᏆᏲᏕᏍᏗ ᎩᏟ.
Have you been to Bartlesville?	ᏤᏙᎸᎢᏍ ᎫᎫ?
He's whittling a handle for an axe.	ᎦᎷᏯᏍᏗ ᎫᎭᎵᏗ ᎠᏲᏢᏍᎦ.
Who put a handle on this hoe?	ᎦᎪ ᎤᏭᎭᏝᏁᎢ ᎯᎠᎦᎶᎪᏗ.
Quail hunters sometimes accidentally shoot one another.	ᎫᏇ ᏧᏂᎰᎯ ᏴᏓᎭ ᎤᏅᏌ ᏓᎾᏓᏲᏍᏙᏗᏍᎪᎢ.
When she finishes peeling potatoes, she washes them in water.	ᏱᏚᏯᎨᏦᎿ ᎾᎾ ᎠᎼᎯ ᏕᎫᎯᎶᏍᎪᎢ.
She's accusing him of stealing apples.	ᏒᎦᏔ ᏕᎦᏃᏍᎩᏍᎬ ᎫᎯᏍᏗᎭ.
How many lids do you want?	ᎯᎳ ᎢᎦ ᏗᎫᏢᏗ ᏕᎦᏚᎵᎭ?
He covered his scar with his hand.	ᎤᏬᏰᏂ ᎬᏗ ᎤᏭᏢᏅ ᎤᏁᎸᏒᎢ.
She boiled three eggs for breakfast.	ᏦᎢᎭ ᏧᏪᏥ ᏚᏭᏅ ᏑᎾᎴ ᏧᏂᎩᏍᏗ.
Squirrels eat acorns.	ᎫᎴ ᏓᏂᎩᏍᎪᎢ ᏌᎶᎵ.
I see a mourning dove flying.	 ᎫᎴ ᏗᏍᎪᏂ ᎦᏃᎯᎵᏒ ᏥᎪᏩᏘ.
The Muskogee fair is in the month of October.	ᏚᏂᏂᏗ ᏓᎸ ᎨᏍ ᏣᎾᏓᏏᏍᎪᎢ ᎫᏐᎢ.
I've already asked someone to pick these rocks up.	ᎦᏳᎳ ᎩᎶ ᏥᏅᏫᏍᏔᎾ ᏧᏭᏖᏍᏗ ᎯᎠ ᏅᏯ ᏔᏂᎳᎨᏯ.
It snowed on Christmas day.	ᏓᏂᏍᏓᏲᎯᎲ ᎢᎦ ᎤᏭᏔᏅᎢ.
He raises watermelons every summer.	ᎪᎩ ᏂᏕᎦᎵᏍᏔᏂᏒ ᎬᎩᏍᏗ ᏓᏛᎯᏍᏗᏍᎪᎢ.
Mother is sifting flour.	ᎢᏌ ᎬᎫᏍᏗᎭ ᎡᏥ.
The roof on the house leaks when it rains.	ᎦᎵᏦᏕ ᎦᎵᏦᏛ ᎬᎪᏍᎪ ᏳᎦᎿᎾ.
He hit the nail with a hammer. She conversed by means of Cherokee.	ᎦᏅᏆᎶᏍᏗ ᎬᏗ ᎤᏩᏂᎸ ᏴᎩ. ᏣᎳᎩ ᎬᏗ ᏚᎵᏃᎮᏢᎢ
I heard a bobcat last night.	 ᎬᎮ ᏂᎦᏪᏍᎬ ᎠᏆᏛᎦᏅ ᎤᏒᎢ ᏥᎨᏒᎢ.
They say he is barely alive.	ᎤᏎᎦᏨ ᎬᎿ ᎠᎾᏗᎭ.
He has a very active family.	ᏙᎯᏳ ᏗᏅᎿᎦᎵᏍᏗ ᏚᏓᏘᎾᎠ.
I have a black car.	ᎬᎿᎨ ᏓᏆᎴᎳ ᎠᏆᎴᎳ ᎠᎩᎭ.
The batter hit the ball hard. Someone is knocking at the door.	ᎪᏍᏛᏂᎯ ᏍᏓᏱ ᎤᏩᏂᎸ ᏍᏆᏞᏍᏗ. ᎩᎶ ᎬᏂᎭ ᎦᎶᎯᏍᏗᎢ.
What do you have cooking?	ᎦᏙ ᎤᏍᏗ ᏨᏂᏍᏗ?
Is that snake lying there alive?	ᎬᏃᏓᏍ Ꮎ ᎢᎾᏓ ᏥᎦᎾ?
The murderer was sentenced to life imprisonment.	Ꮎ ᎠᏍᎦᏯ ᏴᏫ ᎤᏢᎢ ᎬᏅᎢ ᎢᎪᎯᏓ ᎠᏥᏍᏚᏗ ᏚᏚᎪᏓᏏ.
He got choked trying to swallow something whole.	ᎪᎱᏍᏗ ᎬᏩᏃᏍᏓ ᎤᎩᎯᏍᏗ ᎠᏁᎵᏗᏍᎬ ᎤᏴᏥᏅᏨᎢ.
He likes fried potatoes.	ᏄᎾ ᏗᎬᏣᏝᏅ ᏚᎸᏉᏗ.
What are you frying?	ᎦᏙ ᎤᏍᏗ ᎲᏣᎸᏍᎦ?
How many turkeys do you own?	ᎯᎳ ᎢᏯᏂᎢ ᎬᎾ ᏕᎯᎾᏝᎠ?
When the sunshine melted the snow, it became muddy.	ᎠᎦᎵᏍᎬ ᎤᏩᏃᏬᏔᎾ ᎤᏅᏥ, ᏝᏬᏚᎯ ᏄᎵᏍᏔᏅᎢ.
A glass made of plastic melted when she put it in some hot water.	ᎬᎾᏬᏍᎩ ᎪᏢᏔᏅ ᎤᎸᏌᏗ ᎤᏩᎾᏬᏒ ᎤᏗᏞᎩ ᎠᎹ ᎠᏟᏍᏛ ᏭᏝᎾ.
Where is the broom?	ᎭᏢ ᏥᏯ ᎬᏃᏌᏍᏗ?
Sweep the floor before you go.	ᏯᏖᏃ ᎲᏃᏌᎲᎢ ᏂᏣᏂᎩᏓᏊ.
When do blackberries get ripe?	ᎯᎳ ᎢᏴ ᎬᏂᏍᎪ ᎧᏄᎦᏟ?
He is hiding a stolen car.	ᏓᏆᎴᎳ ᎦᏃᏍᎩᏓ ᎬᏍᎦᏢᏍᎦ.
Someone is coming. Hide the gun.	ᎩᎶ ᏓᏯᎢ. ᎲᏍᎦᎳᏓ ᎦᎶᏇ.
He hid his shirt in a drawer.	ᏗᏎᎯᏍᏗ ᎤᏩᏍᎦᎸᏅ ᎤᎿᏬ.
He cracked a bucket full of hickory nuts.	ᎤᎵᏣᏗ ᎧᎵ ᏚᏩᏍᏆᎶᎥ ᏐᎯ.
He doesn't know how much coal to put into the fire.	Ꮭ ᏳᏅᏔ ᎢᎦ ᎤᏮᏘᏗ ᏥᏃᏍᎦ.
How long did you soak the clothes?	ᎯᎳ ᎢᎪᎯᏓ ᏕᏨᏩᎳᏁ ᏗᎿᏬ?
Soldiers were all around.	ᎬᏩᏚᏫᏓ ᏄᎾᏛᏅ ᎠᏂᏲᏍᎩ.
Where did your friend go?	ᎭᏢ ᏫᎦᎶᎯ ᏍᏓᎵᎢ?
I can stay under water for two minutes.	ᎡᎵᏊ ᏔᎵ ᎢᏯᏔᏬᏍᏔᏅ ᏱᎨᏓ ᎠᎹᏱ ᎭᏫᏂ.
The cat is lying underneath the chair.	ᎦᏍᎩᎸ ᎭᏫᏂ ᏗᏜ ᎦᏅᎦ ᏪᏌ.
Meat is less expensive at slaughter houses.	ᏏᏆ ᏧᏂᎯᏍᏗ ᎦᏲᏟᎨ ᏓᎬᏩᎶᏙ ᎭᏫᏯ.
Don't be doing that.	ᏞᏍᏗ ᎥᏍᎩ ᏱᎿᏛᏁᎮᏍᏗ.
These are my children.	 ᎯᎠ ᏗᏇᏥ.
How much does it cost?	ᎯᎳ ᎢᎦ ᏧᎬᏩᎶᏗ?
When do you want me to come and visit you?	ᎯᎳᏴ ᏫᎬᏩᏛᎯᏓᏍᏗ ᏣᏚᎵᎭ?
I have a total of five cows.	ᎯᏍᎩ ᎾᏂᎠ ᏩᎦ ᏕᏥᎾᏝᎠ.
Are you hungry? No.	ᏣᏲᏏᎭᏍ? Ꮭ.
What were you saying? Nothing.	ᎦᏙᎩ ᎭᏗᏍᎨ? Ꮭ ᎪᎱᏍᏗ.
I am going nowhere today.	Ꮭ ᎢᎸᏢ ᏱᏓᎨᏏ ᎪᎯ ᎢᎦ.
Some people have never been in jail.	ᎢᎦᏓ ᏴᏫ Ꮭ ᎢᎸᎯᏳ ᏧᎾᏓᏍᏚᏗ ᏱᎨᏐᎢ.
I see no one that I know.	Ꮭ ᎩᎶ ᏱᏥᎪᏩᏘ ᏥᏲᎵᎩ.
He doctored himself where a wasp stung him by rubbing mud on it.	ᏝᏬᏚ ᎤᏅᎵᏰᎥ ᎠᏅᏫᏍᎬ ᎧᎾᏥᏍᏕᏥ ᎤᏩᏨᏴᎢ.
He's washing a muddy car.	ᏝᏬᏚ ᏓᏆᎴᎳ ᎦᏅᎦᎵᎭ.
She fell in the mud when she slipped.	ᏳᎦᎿᎾ, ᏝᏬᏚᎯ ᏂᏁᏕᎦᎵᏗᏍᎪ ᏕᎦᏅᏅᎢ.
Come here a while.	ᎡᎮᎾ ᏞᎦ.
Did he say he was coming soon?	ᏞᎩᏍ ᏓᎦᎷᏥ ᎤᏛᏁ?
Don't be mean.	ᏞᏍᏗ ᏱᏣᏁᎫᏤᏍᏗ.
Cut down all the dead trees.	ᏧᏪᏘ ᏕᏢᎬ ᏂᎦᏓ ᏕᏥᎴᏴᏍᏔᏅᎢ.
He's feeding a mountain lion .	ᎣᏓᎸ ᎡᎯ ᏢᏓᏥ ᎨᏠᎭ.
Inadawouga. Howa.	ᎢᎾᏓᏬᎤᎦ. ᎰᏩ.
What are you going to use those boards for?	ᎦᏙ ᏙᏛᏔᏂ Ꮎ ᏧᏯᏖᎾ?
You go through a narrow gate when you're going to his house.	ᏯᏙᏟ ᏍᏚᏗ ᎬᏙᎥ ᏫᎦᎶᎯᏍᏗ ᏧᏪᏅᏒ ᏲᎦ.
My mother is always sewing quilts.	ᏂᎪᎯᎸ ᏗᏰᎦᏟ ᏕᎦᏰᏫᏍᎪ ᎡᏥ.
How many do you want?	ᎯᎳ ᎢᎦ ᏕᏣᏚᎵᎭ?
If it isn't night, it's day.	ᎤᏒ ᏂᎨᏒᎾ ᏱᎩ ᎢᎦ ᎨᏐᎢ.
Some of the ball players didn't come.	ᎢᎦᏓ ᎠᎾᎳᏍᎦᎵᏍᎩ Ꮭ ᏳᏂᎷᏤᎢ.
He's just returning from fishing.	ᎩᎳᏛ ᎢᎦᎷᎦ ᎤᏑᏂᏙᎸᎢ.
He used a rope fifty feet long in roping a calf.	ᎯᎩᏍᎪ ᎢᎳᏏᏗ ᎢᎦᏅᎯᏓ ᏍᏕᏱᏓ ᎤᏮᏔᏅ ᏩᎦ ᎠᎩᎾ ᎠᏍᎳᏗᏍᎬᎢ.
I want to buy three ricks of wood.	ᏦᎢ ᎢᎦᏒᏘ ᎠᏓ ᏗᎩᏩᎯᏍᏗ ᎠᏆᏚᎵᎭ.
That ballplayer is six feet, six inches tall.	ᏑᏓᎵ ᎢᎳᏏᏗ, ᏑᏓᎵ ᎢᏏᏔᏗᏍᏗ ᎢᎦᏘ Ꮎ ᎠᎳᏍᎦᎵᏍᎩ.
How long did it take?	ᎯᎳ ᎢᎪᎯᏓ ᎤᏟᎢᎵᏙᎴ?
I stayed there until they adjourned.	ᏫᏓᏂᏰᎵᏍᎬ ᎢᎪᎯᏓ ᏩᏇᏙᎸᎢ.
He has corn planted in an area of one hundred acres.	ᏍᎪᎯᏥᏆ ᎢᏳᏟᎶᏓ ᎢᎬᎾᏕᎾ ᏚᏫᏌ ᏎᎷ.
Did you get here before I did?	ᎢᎬᏱᏍ ᎯᎷᎩ ᏏᏅ ᎠᏴ ᎨᏒ?
This man is the first speaker.	ᎯᎠ ᎠᏍᎦᏯ ᎢᎬᏱ ᎦᏬᏂᏍᎩ.
Let's go pick some green beans.	ᎠᏂᏤ ᏚᏯ ᏗᎾᏕᏑᎦ.
He used to have an old car, but now he has a new one.	ᎤᏪᏘ ᏓᏆᎴᎳ ᏧᎲ ᎠᏎᏅ ᏃᏊ ᎢᏤ ᎤᎭ.
A friend of mine lives in a green house.	ᎢᏤᎢᏳᏍᏗ ᎠᏓᏁᎸ ᎦᏁᎳ ᎣᎩᎾᎵᎢ.
How many years was he gone?	ᎯᎳ ᎢᏧᏕᏘᏴᏓ ᎤᏁᎳᏕᎢ?
Both of you work tomorrow.	ᎢᏧᎳ ᏕᏍᏗᎸᏫᏍᏓᏁᎸ ᏑᎾᎴᎢ.
What size hat do you wear?	ᎯᎳ ᎢᎩᏓ ᎠᎵᏍᏇᏚᏬ ᎭᎵᏍᏇᏚᎲᏍᎩ?
His boat is ten feet long.	ᏍᎪᎯ ᎢᎳᏏᏗ ᏂᎦᏅᎭ ᏥᏳ ᎤᏤᎵᎢ.
Have you ever been bitten by a snake?	ᎢᎸᎯᏳᎢᏍ ᎢᎾᏓ ᏣᎦᏟᏨᎢ?
He walked a few miles before he caught a ride.	ᎢᎸᏍᎩ ᎢᏳᏟᎶᏓ ᎡᎳᏗ ᎤᏂᎩᏒᎢ ᎩᎳ ᎤᏓᏣᏁᎸᎢ.
When I was in the military service, I went away.	ᎠᏂᏲᏍᎩ ᏥᏥᏯᎥ ᎢᎾ ᏩᏇᏙᎸᎢ.
Which snake is the most dangerous?	ᎦᏙ ᎤᏍᏗ ᎢᎾᏓ ᏫᎦᎾᏰᎬᎢ?
The lion went back into the wilderness when it escaped.	ᎢᎾᎨ ᏮᎤᎶᏒ ᏢᏓᏥ ᎤᎵᏘᏌ.
He's too far away to hear you.	ᎢᏅᎯ ᏪᏙᎭ ᏣᏛᎪᏗᎢ.
Go get some flour downtown.	ᎢᏌ ᏫᎩ ᏗᎦᏚᎲ.
Twelve inches make one foot.	ᏔᎵᏚ ᎢᏏᏔᏗᏍᏗ ᏌᏊ ᎢᎳᏏᏗ ᏂᎦᎵᏍᏗᏍᎪᎢ.
Do you like pie made of pumpkin?	ᏣᎸᏉᏗᏍ ᎢᏯ ᎪᏢᏔᏅ ᎨᎵᏍᏗᎩ?
I want a fifteen-cent drink.	ᏍᎩᎦᏚ ᎢᏯᏓᏅᏖᏗ ᏧᎬᏩᎶᏗ ᎠᏗᏔᏍᏗ ᎠᏆᏚᎵᎭ.
Three thousand people came to hear the President speak.	ᏦᎢ ᎢᏯᎦᏴᎵ ᎢᏯᏂ ᏴᏫ ᎤᎾᏛᏓᏍᎠᏂᏢ ᎤᎬᏫᏳᎯ ᎦᏬᏂᏍᎬᎢ.
It's ten minutes past four.	ᏍᎪᎯ ᎢᏯᏔᏬᏍᏔᏅ ᎤᎶᏒᏍᏗ ᏅᎩ.
How far apart do you plant your corn? How often does he visit you?	ᎯᎳ ᎢᏳᏓᎵ ᏕᎯᏫᏍᎪ ᏎᎷ? ᎯᎳ ᎢᏳᏓᎵ ᏣᏩᏛᏂᏙᎰᎢ?
He carried two gallons of blackberries for three miles.	ᏦᎢ ᎢᏳᏟᎶᏓ ᎢᏳᏓᏅᎯᏓ ᎤᏫᏛᎲ ᏔᎵ ᎢᏳᏟᎶᏓ ᎧᏄᎦᏟ.
She used crutches for three weeks.	ᏦᎢ ᎢᏳᎾᏙᏓᏆᏍᏗ ᎢᎪᎯᏓ ᏗᏙᎳᏅᏍᏗ ᏚᏮᏔᏅᎢ.
I want one like it.	ᎥᏍᎩ ᎢᏳᏍᏗ ᎠᏆᏚᎵᎭ.
He stopped by at twelve o'clock.	ᏔᎵᏚ ᎢᏳᏩᏂᎸ ᏥᎨᏒ ᏧᎶᎯᏍᏔᏅᎢ.
How many times have you gone swimming?	ᎯᎳ ᎢᏳᏩᎪᏗ ᎢᏣᏓᏬᏓ ᎪᎯ ᎪᎩ?
Do you speak Cherokee?	ᏣᎳᎩᏍ ᎯᏬᏂᏍᎩ?
How many Cherokees work at the Cherokee Nation?	ᎯᎳ ᎾᏂᎠ ᎠᏂᏣᎳᎩ ᏚᏂᎸᏫᏍᏓᏁ ᏣᎳᎩ ᎠᏰᎵᎢ?
There are tall mountains in North Carolina.	ᏣᎳᎫᏪᏘ ᎢᎾ ᎢᏗᎦᏘ ᏙᏓᎳ.
When a chickadee sings near a house, Cherokees say that someone will come.	ᏥᎩᎵᎵ ᏱᏂᎦᏪ ᎠᏓᏁᎸ ᎾᎥ, ᎩᎶ ᏓᎦᎷᏥ ᎠᎾᏗᏍᎪ ᎠᏂᏣᎳᎩ.
Get one package of chewing gum, okay?	ᏌᏊ ᏂᏕᎦᎳᏗᏍᏛ ᏥᎳᎵ ᏕᎯᏴᎲᎢ, ᎰᏩᏧ?
Have you ever heard about Jesus?	ᎢᎸᎯᏳᎢᏍ ᎯᏯᏍᎩᏨ ᏥᏌ?
My brother likes to hunt rabbits.	ᏦᏍᏓᏓᏅᏟ ᎤᎸᏉᏗ ᏥᏍᏚ ᏧᏲᏍᏗᎢ.
Let's go hunt crawdads.	ᏥᏍᏛᎾ ᏗᎩᏯᎷᎦ.
A scorpion stung him on his foot.	ᏥᏍᏛᎾ ᎠᏓᏧᏯᏍᎩ ᎤᏩᏨᏴ ᎤᎳᏍᎢᏕᏂ.
Some birds migrate south in the winter.	ᎢᎦᏓ ᏥᏍᏆ ᏧᎦᏃᏮ ᏩᏂᎶᏍᎪ ᎪᎳ ᏱᏄᎵᏍᏓᎾ.
A robin has a red breast.	ᏥᏍᏉᏉ ᎩᎦᎨ ᎨᏐ ᎦᏁᏥᎢ.
He likes to eat fried chicken.	ᏥᏔᎦ ᎬᏣᏝᎾ ᎤᎸᏉᏗ ᎤᎩᏍᏗ.
A rooster is sitting on a post crowing.	ᎨᏛ ᎤᎩᎳ ᏥᏔᎦ ᎠᏨᎦ ᎠᏴᎦ.
I see an airplane.	ᏥᏳ ᎠᏝᏫᏗᏍᎩ ᏥᎪᏩᏘᎭ.
Which man is the pilot?	ᎦᏙ ᎤᏍᏗ ᎠᏍᎦᏯ ᏥᏳ ᏗᏝᏫᏘᏗᏍᎩ?
Go straight ahead.	ᏥᏳᎪᏗ ᏫᎶᎯ.
Let's go upstream.	ᏦᎩ ᏗᏜ ᎢᏁᎾ.
I'm going to Texas for three days.	ᏥᎢ ᏧᏒᎯᏓ ᏫᏓᎨᏙᎵ ᏅᏓᎩ.
Turn to the third page.	ᏦᎢᏁ ᎤᎦᏅᏓᏛ ᏫᏴᏈᏓᎩ.
He's been gone since Wednesday.	ᏦᎢᏁ ᎢᎦ ᏥᎨᏒ ᎬᏩᏂᎩᏓ.
Long ago the Cherokees raised tobacco.	ᎪᎯᎩ ᏥᎨᏒ ᏦᎳ ᎠᎾᏛᎯᏍᏗᏍᎬ ᎠᏂᏣᎳᎩ.
If the windows happen to be open, close them.	ᏗᏍᏚᎢᏓ ᎢᎨᏎᏍᏗ ᏦᎳᏂ, ᏕᎯᏍᏚᏅᎢ.
They have various things on sale.	ᏧᏓᎴᏅᏓ ᎤᏂᏍᎪᎵᏗᏓᎾ.
Who is the chairman of your group?	ᎦᎪ ᏧᏓᏘᎿᎢ ᎢᏣᏓᎷᎬᎢ?
Geese head south when winter comes.	ᏧᎦᏅᏮ ᏗᏜ ᏓᏄᎪᏗᏍᎪ ᏌᏌ ᎪᎳ ᏱᏄᎵᏍᏔᎾ.
The farmer is planting cabbage.	Ꮎ ᏗᎦᎶᎩᏍᎩ ᏧᎦᎾᏕᎾ ᎠᏫᏍᎦ.
Are you afraid of centipedes?	ᎦᎯᏍᎦᎰᏍ ᏧᏂᎦᏃᏥ?
If the price is too high, I'm not going to buy the car.	ᎦᎸᎳᏗ ᏧᎬᏩᎶᏗ ᎢᎨᏎᏍᏗ, Ꮭ ᏱᏛᎩᏩᏏ ᏓᏆᎴᎳ
Wealth does not cause happiness.	Ꮭ ᏧᎬᏩᎶᏗ ᏱᏂᎬᎯᏏᏍᎪ ᎠᎴᎮᎵᏍᏗ ᎨᏒᎢ.
In the past there weren't as many storms.	ᏧᏟᎢᎸᏍᏔᏅ Ꮭ ᎥᏍᎩ ᎢᎦ ᏱᏗᎦᏃᎸᏍᎨᎢ.
If milk is left out in the heat too long, it becomes sour.	ᎪᎯᏗ ᎤᏗᏞᎬ ᏱᎦᏁ ᎤᏅᏗ, ᏧᎿᏦᏍᏗ ᏂᎦᎵᏍᏗᏍᎪᎢ.
The boy's clothes are being washed for him.	ᏧᎿᏬ ᏓᎬᎩᎶᎡᎭ ᎠᏧᏣ.
The wind is from the north.	ᏧᏴᏢᎢ ᏗᏜ ᏧᎦᏘ ᎦᏃᎸᏍᎬᎢ.
He's putting up barbed wire fence around the pasture.	ᏧᏣᏲᏍᏗ ᎤᏯᏅ ᎠᏏᎳᏛᏍᎦ ᏠᎨᏒ.
His friend became a bullfighter.	ᏩᎦ ᏧᎧᏅᏍᏕᎾ ᏗᎵᏍᏗᏍᎩ ᏄᎵᏍᏔᏅ ᎤᎾᎵᎢ.
Is it smoky because of grass fires?	ᏕᎦᎵᎦᏍ ᏂᎦ ᏧᏒᏍᏗ ᏥᎩ?
They say he was asphyxiated by smoke.	ᏧᎦᏒᏍᏗ ᎤᎭᏴᎴ ᎠᎾᏗᎭ.
I almost stepped on a copperhead.	ᎠᎴ ᏧᎦᏔᏥᏍᏓᏟ ᏂᏥᏯᎳᏍᏛᏓ.
The sunshine is very blinding.	ᎤᏙᎯᏳ ᏧᎦᏙᏴᎢᏍᏗ ᎠᎦᎵᎭ.
This man was bitten by an alligator.	ᏧᎳᏍᎩ ᎤᏍᎦᎵᏨ ᎯᎠ ᎠᏍᎦᏯ.
My mother has an old cast iron pot.	ᎤᏪᏘ ᏧᎳᏍᎩ ᎤᎭ ᎡᏥ.
If he was brave, he wouldn't have run away.	ᏧᎵᏨᏯᏍᏗ ᏱᎨᏎ, Ꮭ ᎯᎬᏩᎵᏘᏎᎢ.
He talks to deaf people in sign language.	ᏧᏬᏰᏂ ᎬᏗ, ᏓᏟᏃᎮᏗᏍᎪ ᏧᏂᎵᎡᎾ ᏴᏫ.
He likes to fish for catfish.	ᏧᏂᎵᏍᏓᎾᎵ ᏧᏑᏗ ᎤᎸᏉᏗ.
Where did you put my striped shirt?	ᎭᏢ ᏣᏅᏁ Ꮎ ᏧᎶᎸᏗ ᎠᏆᎿᏬ?
Do you work nightly?	ᏧᎵᏏᏅᏓᏍ ᏕᏣᎸᏫᏍᏓᏁᎰᎢ?
The workers are on a noon break.	ᎢᎦ ᎤᏂᏲᎯᏍᏗ ᏧᏂᎸᏫᏍᏓᏁᎯ.
They are going to build a new jail.	ᎢᏤ ᏧᎾᏓᏍᏚᏗ ᏛᎾᏁᏍᎨᎯ.
Which school did you attend?	ᎦᏙ ᎤᏍᏗ ᏧᎾᏕᏠᏆᏍᏗ ᏕᏣᏕᏠᏆᎡᎢ?
My friend is employed at a restaurant.	ᏧᎾᎵᏍᏓᏴᏗ ᎠᏥᎾᏝᎠ ᎣᎩᎾᎵᎢ.
She does her laundry on Fridays.	ᏧᏅᎩᎶᏍᏗ ᎢᎦ ᏕᎬᎩᎶᏍᎪᎢ.
How long were you in the hospital?	ᎯᎳ ᎢᎪᎯᏓ ᏫᏅᎨᎢ ᏧᏂᏢᎩᎢ?
In the year 1974, the Cherokees built a new motel near Tahlequah.	ᏐᏁᎳᏚ ᎢᏍᎪᎯᏥᏆ ᎦᎵᏆᏍᎪ ᏅᎩ ᎤᏕᏘᏴᏌᏗᏒ ᎢᏤ ᏧᏂᏒᏍᏗ ᎤᎾᏁᏍᎨᎲ ᎠᏂᏣᎳᎩ ᏓliᏆ ᏅᎥᎢ.
He went on a vacation for ten days.	ᏍᎪᎯ ᏧᏒᎯᏓ Ꮩ ᎤᏪᏙᎸ ᏚᎸᏫᏍᏓᏁᎲᎢ.
I am going to my friend's house.	ᎣᎩᎾᎵᎢ ᏧᏪᏅᏒ ᏫᏓᎨᏙᎵ.
Is Satan from hell?	ᏨᏍᎩᏃᎢᏍ ᎡᎯ ᏎᏓᏂ?
Groundhog day is in the month of February.	ᎧᎦᎵ ᎧᎸ ᎤᏅᎪᎢᏍᏗ ᎨᏐᎢ.
I like strong coffee.	ᎤᏴᏍᏗ ᎧᏫ ᎠᎩᎸᏉᏗ.
The bucket is full of water.	ᎠᎹ ᎧᎵ ᎠᏟᏍᏗ ᏒᏙᏂ.
Locusts make good posts.	ᎧᎶᏇᎩᏗ ᏦᏍᏓ ᏗᎨᏛᏍᏗ ᏓᏙᏢᏍᎪᎢ.
I grew up close to Locust Grove.	ᎧᎶᏇᎩᏗ ᎾᎥ ᎠᏆᏛᏒᎢ.
She bought sugar to make candy.	ᎧᏎᏥ ᎤᏩᎯ ᎧᏎᏥ ᏧᏬᏢᏙᏗ.
What month is your birthday?	ᎦᏙ ᎤᏍᏗ ᎧᎸ ᏣᏕᏘᏱᏍᎩ?
There's a butterfly on your shirt.	ᎧᎹᎹ ᎤᎩᎳ ᏣᏄᏮᎢ.
They're hunting wild elephants.	ᎧᎹᎹ ᎠᏁᏯᏔᎯ ᏚᏂᏲᎭ.
There are wasps flying around outside.	ᎧᎾᏥᏍᏕᏥ ᎠᏂᏃᎯᎵᏙᎭ ᏙᏱ.
He barely ascended the mountain.	ᎤᏎᎦᏨ ᎤᎿᎷᏒᎢ ᎣᏓᎸᎢ.
His car stalled going uphill.	ᎧᎾᎷᏍᎬ ᎤᎴᏫᏍᏓᏁᎸ ᏓᏆᎴᎳ.
Put anger aside.	Ᏼ ᏂᏨᎦ ᎧᎾᎸᎢᏍᏗ.
He angered the wasps by hitting them with rocks.	ᏅᏯ ᎬᏗ ᏕᎬᎯᎲ ᏚᎿᎸᏍᏔᏅ ᎧᎾᏥᏍᏕᏥ.
A spider is making a web.	ᎧᎾᏁᏍᎩ ᎧᏂᎳᏕᏫᏍᎦ.
He cut his little toe with an axe .	ᎤᏍᏗ ᎧᎾᏌᏛ ᎤᏓᏴᏝᎸ ᎦᎷᏯᏍᏗ ᎬᏗ.
He's rooting out bushes.	ᏕᎧᎾᏍᏕᏟᎭ ᏚᏩᎢᏢᎢ.
Bring a pick when you come.	ᎧᎾᏍᏕᏢᏗ ᎯᏃᏢ ᎯᎷᏨᎢ.
I get cold when it's cold outside.	ᏥᎾᏬᎪ ᏳᏴᏜ ᏙᎯ.
Did he answer when you were speaking to him, or not?	ᎧᏁᎩᏍ ᏥᏯᎵᏃᎮᏗᏍᎬ, ᏝᎨ?
He pried the stump with a crowbar.	ᎨᏘᎶᏍᏗ ᎬᏗ, ᎤᏁᏆᏛᎲ ᎤᏂᎷᎬᎢ.
He increased his work load when he finished school.	ᎤᏁᏉᎥ ᏧᎸᏫᏍᏓᏁᏗ ᎤᏍᏆᏓ ᏓᏕᏠᏆᏍᎬᎢ.
The patient's fever is increasing.	ᎤᏢᎩ ᎤᏗᏞᎲᏍᎬ ᎧᏁᏉᎦ.
I thought I mentioned it.	ᏣᎩᎢᏁᎢᏍᏔᏅ ᎨᎵᏍᎬ.
I guess it's heating up because there's foreign matter in the water line.	ᎠᎹᏛ ᎠᏎ ᎧᎾᏌᏝ ᏣᏖᏴᏍᎦ.
Who put foreign matter in the well?	ᎦᎪ ᎤᏁᏌᏝᏁ ᎠᎹᏢᏗᎢ?
These boxes are empty.	ᎯᎠ ᏗᎧᏁᏌᎢ ᏧᏏᏩ.
A young bird fell out of a nest.	ᎧᏁᏍᏓᏝᎲ ᏓᎦᎶᎯ ᏥᏍᏆ ᎠᏓ.
In the summertime, the boys haul hay.	ᎪᎩ ᏱᏄᎵᏍᏔᎾ, ᎧᏁᏍᎦ ᎠᏂᎾᏌᏁᏍᎪ ᎠᏂᏧᏣ.
She had surgery on her knee last May.	ᎠᏂᏍᎬᏘ ᏥᎧᎸ ᎠᏥᏰᏝᎸ ᎧᏂᎨᏂ.
I'm going to collect from him what he owes me when I see him.	ᏥᏚᎬ ᎢᎦ ᏓᏥᏂᏝᏂ ᏥᎪᎥᎢ.
What do you use to kill rats?	ᎦᏙ ᎤᏍᏗ ᏕᎯᎯᏍᏗᏍᎪᎢ ᎧᏂᏈᏌ?
He's eating a chicken wing. 	ᏥᏔᎦ ᎧᏃᎨ ᎠᏍᏗᎩᎠ.
He broke his arm when he fell.	ᎧᏃᎨᏂ ᎤᎵᏍᏆᎵᏎᎸ ᎤᏅᏣ.
The newscaster is telling the news. A preacher preached the gospel to the people.	ᎧᏃᎮᏓ ᎧᏃᎮᏍᎩ ᎧᏃᎮᏓ ᎧᏃᎮᎭ. ᎠᎵᏣᏙᎲᏍᎩ ᎧᏃᎮᏓ ᏚᎵᏣᏙᏁᎸ ᏴᏫ.
Don't tell what happened.	ᏞᏍᏗ ᏥᎯᏃᎮᏟ ᏄᎵᏍᏔᏂᏙᎸᎢ.
Did you omit him on purpose?	ᎠᏎᎢᏍ ᎯᏃᎯᏰᎢ?
Cherokee Baptists eat Passover Supper every three months.	ᏦᎢ ᎢᏯᏅᏓ ᎢᏳᏓᎵ ᎧᏃᎯᏰᎩ ᎠᎾᎵᏍᏓᏴᎲᏍᎪ ᎠᏂᏣᎳᎩ ᏗᎾᏓᏬᏍᎩ.
The mother is fanning her baby.	ᎤᏍᏗ ᎤᏤᎵ ᎧᏃᏰᎭ ᎤᏓᏥᎢ.
Do you like to drink sassafrass tea?	ᏣᎸᏉᏗᏍ ᎧᎾᏍᏓᏥ ᎠᎦᏅ ᏣᏗᏔᏍᏗ?
I want to pick blackberries. 	ᎧᏄᎦᏟ ᎠᏆᏕᏍᏗ ᎠᏆᏚᎵᎭ.
He's shooting bullfrogs with arrows.	ᎦᏟᏓ ᎬᏗ ᏓᏲᎯᎭ ᎧᏄᎾ. 
It was misting when I came in.	ᎧᏄᏲᎳᏗᏍᎬᏛ ᏥᏓᏥᏴᎠ.
She strains sassafras tea with a cloth.	ᎠᎿᏬ ᎬᏗ ᎧᏅᏐᎸᏍᏗᏍᎪ ᎧᎾᏍᏓᏥ ᎠᎦᏅᎢ.
Which room is the patient in?	ᎦᏙ ᎤᏍᏗ ᎧᏅᏑᎸ ᎠᏯᎠ ᎤᏢᎩ?
A medicine man cured the boy's earache. A welder is welding a hole in a cast iron pot.	ᏗᏓᏅᏫᏍᎩ ᎤᏅᏩᏅ ᎠᏧᏣ ᎦᎴᏂ ᎤᏪᏍᏓᏁᎲᎢ. ᏧᎳᏍᎩ ᎠᏔᎴᏍᏒ ᎧᏅᏫᎠ ᏔᎷᎩᏍᎩ ᏗᎧᏅᏫᏍᎩ.
I was born April second, nineteen hundred forty six.	ᎧᏬᏂ ᏔᎵᏁ, ᏐᏁᎳᏚ ᎢᏍᎪᎯᏥᏆ ᏅᎩᏍᎪ ᏑᏓᎵ ᎠᏆᏕhᏁᎢ.
The boy is breathing hard because he ran a long distance.	Ꮎ ᎠᏧᏣ ᎤᏓᏅᎯᏓ ᎤᏓᎾᏩᏍᏔᏅ ᎢᏳᏍᏗ ᏍᏓᏯ ᎧᏬᎳᏕᎠ.
Ducks like water.	ᎧᏬᏄ ᎠᎹᏱ ᎤᏂᎸᏉᏗ.
His nose is peeling due to the hot sun.	ᎧᏴᏐᎵ ᎠᏓᏁᎦᎵ ᎤᏗᏞᎩ ᎠᎦᎵᏍᎬ ᎢᏳᏍᏗ.
When did her husband part with her? I didn't know he was not living.	ᎯᎳ ᎢᏴ ᏥᎨᏒ ᎤᏮᏕᏤ ᎠᏂᏁᎵ? Ꮭ ᏯᏆᏅᏖ ᏁᎲᎾ ᎨᏒᎢ.
I use a cane when I walk around.	ᎠᏙᎳᏅᏍᏗ ᎬᏗᏍᎪ ᏯᏇᏙᎳ.
Put out the fire; it's too hot. The lightning put the lights out.	ᎲᏜᏓ ᎪᏛᎢ; ᏙᏳ ᎤᏗᏞᎦ. ᏓᏨᏍᏛ ᏚᏮᎳᏛ ᎠᎾᎦᎵᏍᎩ.
Are you still sharpening the axe?	ᏏᏍ ᎲᏟᎭ ᎦᎷᏯᏍᏗ?
When the wood burned up, the fire went out. 	ᏚᎪᏃᎿ ᎠᏓ ᎤᏮᏠᏒ ᎪᏛᎢ.
They always put paper into the the fire.	ᏂᎪᎯᎸ ᏗᎪᏪᎵ ᏓᏅᏛᎥᏍᎪ ᎪᏛᎢ.
She likes to mingle with a lot of people.	ᏥᏈᏍᏗ ᏴᏫ ᏄᎾᏛᎲ ᎤᏪᎳᏗᏓᏍᏗ ᎤᎸᏉᏗ.
My friend is a member of the Tahlequah police force.	ᎣᎩᎾᎵᎢ ᏓᎵᏆ ᏗᎾᏓᏂᏱᏍᎩ ᎤᎾᏙᏢᏒᎢ ᎨᎵ. 
He's sending his camel to bed.	ᏗᎦᏂᏢ ᎦᏅᏍᎦ ᎤᏤᎵ ᎨᎻᎵ. 
His chain broke but he linked it back together.	ᎤᎾᏓᏕᏒᏓ ᏚᎵᎦᎵᏎᎸᎢ ᎠᏎᏅ ᏚᏫᏝᏅᎢ.
I will go to town later.	ᎩᎳ ᏫᎨᏙᎸ ᏗᎦᏚᎲᎢ.
I went to sleep early last night. I have just closed the window.	ᎩᎳ ᎤᏒ ᎠᎩᏢᏅ ᎤᏒ ᏥᎨᏒᎢ. ᎩᎳ ᏫᏥᏍᏚᎲᎦ ᏦᎳᏂ.
We'll get there pretty soon.	ᎩᎳᏊ ᏫᏓᏗᎷᏥ.
When he was wounded, a doctor was there immediately. 	ᎠᏥᏐᏅᎿ ᎩᎳᏊ ᎢᏴᏓ ᎤᎷᏨ ᎠᎦᎾᎦᏘ.
Can someone tell me what's happening?	ᎡᎵᏊᏍ ᎩᎶ ᏯᎩᏃᎯᏍ ᏂᎦᎵᏍᏔᏅᏍᎬ?
Chipmunks live in the woods.	ᎢᎾᎨ ᎠᏁᎰ ᎩᏳᎦ. 
When she took the sheet out of the dryer, she shook it. 	ᎦᏂᏟ ᎠᏰᏍᏛᏗ ᎤᎴᏌ ᏗᎧᏲᏗᏍᎩᎢ ᎤᏮᏣᎬᏅᎢ. 
The Spades are my cousins.	ᎠᏂᎪᏕᏍᎩ ᎪᎱᏍᏗ ᏗᏋᏂ.
Crows are corn thieves.	ᎪᎦ ᏎᎷ ᏗᏂᏃᏍᎩᏍᎩ.
I saw him a while ago. 	ᎪᎯ ᏥᎨᏒ ᏥᏥᎪᎥ.
Wait for me. I'll be back after a while. 	ᏍᎩᎦᏘᏰᏍᏗ. ᎪᎯᏴ ᏛᏥᎷᏥ.
Dogs like to eat bones. 	ᎪᎳ ᏧᏂᏍᏗᎩᏍᏗ ᎤᏂᎸᏉᏗ ᎩᏟ.
Take the ashes out of the stove.	ᎪᏍᏚ ᎯᎳᎩ ᏍᏏᎢ.
His pants became dusty when he fell.	ᎪᏍᏚᎭ ᏄᎵᏍᏔᏅ ᎤᏑᎸ ᎤᏅᏣ.
Where does the dipper hang? 	ᎭᏢ ᎬᏙᎣ ᎠᎫᎩᏍᏗ?
When I returned from hunting, I hung up my gun.	ᎠᎩᏃᎭᎵᏙᎸ ᎢᎠᎩᎷᏣ ᎠᏋᏙᏌᏛᎢ ᎦᎶᏇ.
Birds like to eat mulberries. 	ᏥᏍᏆ ᎤᏂᎸᏉᏗ ᎫᏩ ᎤᏂᎩᏍᏗᎢ.
Lighting struck a sycamore tree. 	ᎫᏩᏧᏁᎦ ᏡᎬ ᎤᏩᏂᎸ ᎠᎾᎦᎵᏍᎩ.
He sells a lot of huckleberries in the summer.	ᎫᏩᏯ ᏥᏈᏍᏗ ᎦᎾᏕᎪᎢ ᎪᎩ ᏱᏄᎵᏍᏔᎾ.
My brother works at Pryor.	ᎫᏩᏲ ᏫᏚᎸᏫᏍᏓᏁᎰ ᏦᏍᏓᏓᏅᏟ.
What are you planning to do July fourth?	ᎦᏙ ᏣᏛᏁᏗ ᏕᏧᎪᏗ ᎫᏰᏉᎾ ᏅᎩᏁᎢ?
I have a coon dog for sale.	 ᎬᏟ ᏧᏲᎯ ᎩᏟ ᎠᎩᏍᎪᎵᏗ.
I thought he was hiding, but he was standing in view. 	ᎤᏗᏍᎦᏝ ᎡᎵᏍᎬ ᎠᏎᏅ ᎬᏂᎨᏒ ᏓᎦᏙᎬᎢ.
This farmer raises peaches and sells them.	ᎯᎠᏗᎦᎶᎩᏍᎩ ᏆᎾ ᏓᏛᎯᏍᏗᏍᎪ ᏕᎦᎾᏕᎪᎢᏃ.
We saw a six-foot cobra. 	ᏑᏓᎵ ᎢᎳᏏᏗ ᎢᎦᏅᎯᏓ ᏆᎾᏓᏲᎭ ᎣᏥᎪᏩᏔ.
Every summer my mother picks plums and cans them.	ᎪᎩ ᏱᏄᎵᏍᏔᎾ ᏆᏄᎾᏍᏗᎢ ᏕᎦᏕᏍᎪ ᎡᏥ ᎠᎴ ᏕᎦᎶᏗᏍᎪᎢ.
You can hear locusts in the heat of the summer.	ᎪᎩ ᎤᏗᏞᎩ ᏗᏛᎪᏗ ᎾᏂᏪᏍᎬ ᎶᎶ.
Here! Here is the money I owe you!	Ꮎ! ᎠᎭᏂ ᎠᏕᎳ ᏥᏍᎩᏚᎦ.
Where did you put those wheels?	ᎭᏢ ᏕᎯᎲᎦ Ꮎ ᏗᎦᏆᏘᏗ.
You're not going until then?	ᎾᎯᏳᎢᏍ ᎩᎳ ᏖᏏ?
There are five workers.	ᎯᏍᎩ ᎾᏂᎠ ᏧᏂᎸᏫᏍᏓᏁᎯ.
Go stand near him.	ᏗᎦᏙᎬ ᎾᎥ ᏩᎴᎲᎦ.
Do you know how to make hominy? 	ᎯᎦᏔᎭᏍ ᏁᏩᏓ ᏦᏢᏗ?
Look! Who's that coming?	Ꮒ! ᎦᎪ ᏥᏓᏯᎢ?
All the people heard him speak.	 ᏂᎦᏓ ᏴᏫ ᎬᏩᏛᎦᏅ ᎦᏬᏂᏍᎬᎢ.
Have you already forgotten what he said? A cat is meowing.	ᎦᏳᎳᏍ ᏨᎨᏫᏎ ᏄᏪᏒᎢ? ᏪᏌ ᏂᎦᏪᎠ.
He's always playing ball during the summer.	 ᏂᎪᎯᎸ ᎠᎳᏍᎦᎵᏍᎪ ᎪᎩ ᏱᎩ.
Take your watch off before you dive into the water.	 ᏅᏅᏓᎩ ᏩᏥ Ꮟ ᎠᎹᏱ ᏫᏂᏣᏕᏘᏅᎾ.
He put a lock on the door.	ᏓᎩᏏ ᏄᏩᏅᏔᏅ ᎦᎶᎯᏍᏗᎢ.
He wants to talk to you. 	ᏂᎯ ᏍᏓᏟᏃᎮᏗ ᎤᏚᎵᎭ.
She says she hurts all over. She likes to go everywhere.	 ᏂᎬ ᎤᏪᎯᏍᏓᏁᎵᏙᎭ ᎠᏗᎭ. ᏂᎬ ᎤᏪᏙᎵᏓᏍᏗ ᎤᎸᏉᏗ.
They want you two to go now. 	 ᏃᏊ ᏍᏕᏅᏍᏗ ᎤᎾᏚᎵᎭ.
They might come tomorrow and then they might not.	ᏯᏂᎷᎩᏊ ᏑᎾᎴ ᏃᏊᎴ ᏄᏂᎷᏨᎾᏊ ᏱᎩ.
They make lumber out of pine. 	ᏧᏯᏖᎾ ᏓᏃᏢᏗᏍᎪᎢ ᏃᏥ. 
There are a lot of stars out tonight.	ᏥᏈᏍᏗ ᏃᏈᏏ ᎠᏂᎧᎳ ᎪᎯ ᎤᏒᎢ.
When the streets freeze over, the road maintenance crews dump sand on them.	ᏕᎦᎳᏅᏛ ᏱᏚᏁᏍᏓᎳᏓ ᏃᏯ ᎠᏂᎳᎨᏯᏛᏍᎪᎢ ᏅᏃᎯ ᏧᏂᎸᏫᏍᏓᏁᎯ.
Willy has a different car.	ᏫᎵ ᏄᏓᎴ ᏓᏆᎴᎳ ᎤᎭ.
You are really crazy.	ᏙᏳ ᏂᏣᏓᏅᏛᎾ. 
Tell him to come as quickly as possible.	 ᏄᏟᏍᏛ ᏤᏒ ᎯᏲᏎᎸᎢ.
Hurry or we'll be late.	ᏄᎳ, ᏓᎩᏂᎪᏂᏲᏥᏍ.
Come here. I want to tell you something.	 ᏄᎳ. ᎪᎱᏍᏗ ᎬᏃᎯᏎᏗ ᎠᏆᏚᎵ.
He has twenty acres of potatoes planted.	ᏔᎵᏍᎪᎯ ᎢᏳᏟᎶᏓ ᎢᎬᎾᏕᎾ ᏚᏫᏌ ᏄᎾ.
What do you have on your arm?	ᎦᏙ ᎤᏍᏗ ᏂᏨᏅᏗ ᎯᏃᎨᏂ?
When are you going to New York? 	ᎯᎳ ᎢᏴ ᏖᏏ ᏄᏯᎩ?
The sun is bigger than the moon.	ᎢᎦ ᎡᎯ ᏅᏓ ᎤᎪᏗ ᎤᏔᎾ ᏏᏅ ᏒᏃᏱ ᎡᎯ ᏅᏓ ᎨᏒᎢ.
It starts getting cold in the month of November. 	ᏅᏓᏕᏆ ᎧᎸ ᎠᏓᎴᏂᏍᎪ ᎤᏴᏢᎢ.
Where is a calender? 	ᎭᏢ ᏅᏓ ᏗᏎᏍᏗ?
I went to Texas during my vacation.	ᏅᏓᎩ ᏩᏇᏙᎸ ᏙᎢ ᎨᏙᎲ ᎢᎪᎯᏓ.
Do you believe that man has been on the moon?	ᏦᎯᏳᎭᏍ ᏅᏙᎯ ᎤᏪᏙᎸ ᎨᏒ ᏴᏫ?
He runs four miles every morning.	ᏅᎩ ᎢᏳᏟᎶᏓ ᎠᏓᎾᏫᏍᏗᏍᎪ ᏂᏚᎩᏨᏂᏒᎢ.
Some workers have a day off on the fourth of July.	ᎫᏰᏉᎾ ᏅᎩᏁ ᏙᎢ ᎠᏁᏙᎰ ᎢᎦᏓ ᏧᏂᎸᏫᏍᏓᏁᎯ.
Come back on Thursday.	ᏅᎩᏁ ᎢᎦ ᎢᎮᏙᎸᎢ.
Someone is walking in the middle of the road.	ᏅᏃᎯ ᎠᏰᏟ ᎠᎢ ᎩᎶᎢ.
Let's live in peace. 	ᏅᏩᏙᎯᏯᏓ ᎢᏕᎮᏍᏘ.
I want medicine for a cold.	ᎤᏴᏜ ᎣᏂᎣᏍᎬ ᏅᏬᏘ ᎠᏆᏚᎵᎭ.
Don't drink the rubbing alcohol.	ᏞᏍᏗ ᏥᎭᏗᏔᎯ Ꮎ ᏅᏬᏘ ᎠᏓᎯᎯ.
The rocks were too heavy to lift if no one helped.	ᏗᎦᎨᏗ ᎨᏒ ᏗᏌᎳᏙᏗ ᏅᏯ ᎩᎶ ᏃᏍᏕᎵᏍᎬᎾ ᏱᎩ.
He lives in a house made of bricks.	ᏅᏯ ᏗᏛᏓᏅᎢ ᎠᏁᏍᎨᏔᏅ ᎠᏓᏁᎸ ᎦᏁᎳ.
She lives in a place called Rocky Mountain. He made a garden in a rocky place. 	ᏅᏲᎯ ᎣᏓᎸ ᏚᏙᎥ ᎦᏁᎳ. ᏅᏲᎯ ᎤᏬᏢᏅ ᏠᎨᏏ.
Eagles live high atop the mountains.	ᏙᏓᎸ ᎦᎸᎳᏗ ᎠᏁᎰ ᎠᏬᎭᎵ.
Oklahoma means "red man" in the Choctaw language.	ᎣᎦᎳᎰᎹ ᏥᎩ "ᎩᎦᎨ ᎠᏍᎦᏯ" ᎠᏗᎭ ᎠᏂᏣᏓ ᎤᏂᏬᏂᎯᏍᏗ.
That man traps groundhogs. 	Ꮎ ᎠᏍᎦᏯ ᎣᎦᎾ ᏓᏌᏛᎥᏍᎪᎢ.
Hand me the face soap.	Ꮎ ᎣᏝ ᎠᎬᏍᏉᏍᏙᏗ ᎡᏍᎬᏏ.
He came afterwards. 	ᎣᏂ ᎤᎷᏨᎢ.
Stand behind me.	ᏥᏙᎬ ᎣᏂ ᏗᏜ ᎯᏙᎨᏍᏗ.
This meat is good to eat. He speaks well.	ᎯᎠ ᎭᏫᏯ ᎣᏍᏓ ᎠᎩᏍᏗ. ᎣᏍᏓ ᎦᏬᏂ.
He's a preacher of the good news.	ᎣᏍᏓ ᎧᏃᎮᏓ ᎠᎵᏣᏙᎲᏍᎩ.
I'm doing fairly well. 	ᎣᏏ ᎾᏆᏛᎿᏕᎦ.
Where shall I set this stove?	ᎭᏢ ᏓᏥᎧᏂ ᎯᎠ ᎣᏏ?
She won a new range in a contest.	ᎢᏤ ᎣᏍ ᎠᏓᏍᏓᏴᏗ ᎤᏓᏒᏅ ᎠᎾᏓᎪᎾᏘᏗᏍᎬᎢ.
He's cutting wood for a heating stove.	ᎣᏏ ᎠᎦᎾᏬᎯᏍᏗ ᏗᎲᏘᏗ ᎠᏓ ᏓᏍᏆᎸᏍᎦ.
Do you feel all right?	ᎣᏏᏊᏍ ᏣᏓᏅᏔ?
Hello. Are you well?	ᎣᏏᏲ. ᏙᎯᏧ?
He catches rabbits with traps.	ᏗᏌᏛᏗ ᎬᏗ ᏕᎦᏂᏱᏍᎪ ᏥᏍᏚ.
Count from one to twenty.	ᏔᏎᎦ ᏌᏊ ᏂᏛᎴᏂᏍᎩ ᏔᎵᏍᎪᎯ ᏩᏍᏘ.
He's wearing a blue cap.	ᏌᎪᏂᎨ ᎤᎵᏑᏫᏓ ᎤᎵᏍᏚᎳ.
Possums like to eat persimmons.	ᎤᎾᏤᏥᏍᏗ ᏌᎵ ᏧᏂᎩᏍᏗ ᎤᏂᎸᏉᏗ.
I hooked a snapping turtle while I was fishing at the pond.	ᏌᎵᎫᎩ ᏥᏰᏒ ᎥᏓᎵ ᎦᏑᎲᏍᎬᎢ.
I shot a squirrel with a .22 rifle.	ᏔᎵᏦᏁ ᎬᏗ ᏥᏲᎸ ᏌᎶᎵ.
Geese head south when it turns winter.	ᏧᎦᏃᏮ ᎾᎾᏛᎾᏗᏍᎪ ᏌᏌ ᎪᎳ ᏱᏄᎵᏍᏔᎾ.
This rock is hard. He's working hard.	ᎯᎠ ᏅᏯ ᏍᏓᏯ. ᏍᏓᏯ ᏚᎸᏫᏍᏓᏁ.
They have a swing made of rope.	ᏍᏕᏱᏓ ᎪᏢᏔᏅ ᎠᏓᏁᏐᎳᏕᏗ ᎤᏃᏢᎭ.
They were a little tired from playing ball.	ᏍᏗᎩᏓ ᏚᏂᏯᏪᎬᎢ ᏍᏆᎴᏍᏗ ᏚᎾᏁᎶᏅᎢ.
Close the gate when the cows go by.	ᎯᏍᏚᏅ ᏍᏚᏗ Ꮎ ᏩᎦ ᎠᏂᎶᏐᏅᎢ.
A key is for unlocking a door.	ᏍᏚᎢᏍᏗ ᎦᎶᎯᏍᏗ ᎠᏍᏚᎢᏍᏙᏗ.
If you haven't been confronted by Satan today, it's possible you two are walking in the same direction.	ᏎᏓᏂ ᏗᏣᏠᏒ ᏂᎨᏒᎾ ᏱᎩ ᎪᎯ ᎢᎦ, ᎡᎵᏊ ᎢᏣᎳᎭ ᏱᏍᏓᎢ.
Some dressers are made of walnut.	ᎢᎦᏓ ᏗᏎᎯᏍᏗ ᏎᏗ ᎠᏓ ᏗᎪᏢᏔᏅ ᎨᏐᎢ.
It's difficult to see a green snake in the grass.	ᏎᎳᏉᏯ ᏍᏓᏱ ᎠᎪᏮᏛᏗ ᎦᏄᎸᏒᎢ.
How much corn did you raise this summer?	ᎯᎳ ᎢᎦ ᏎᎷ ᏕᎭᏛᎯᏍᏓ ᎪᎯ ᎪᎩ
The farmer is planting some popcorn.	Ꮎ ᏗᎦᎶᎩᏍᎩ ᏎᎷ ᎠᎾᏔᏍᎩᏍᎩ ᏓᏫᏍᎦ.
He accidentally spilled a sack of corn meal.	ᏎᎷ ᎢᏌ ᎦᏅᏛ ᎤᏤᏩᏍᏙᏔᏅᎢ.
He's burning some dry corncobs.	ᏎᎷ ᏧᏓ ᏧᎧᏲᏓ ᏓᎪᎲᏍᏗᎭ.
I watch the news at ten o'clock each night on my television set.	ᏍᎪᎯ ᎢᏳᏩᏂᎸ ᏂᏚᎵᏏᏂᏒ ᎦᎦᏙᏍᏗᏍᎪ ᎧᏃᎮᏓ ᎠᏓᏴᎳᏛᏍᎩ ᎠᎩᎲᎢ.
He's coming back the tenth of next month.	ᏍᎪᎯᏁ ᏐᎢᎧᎴᏍᏗ ᏛᎦᎷᏥ.
There were about a hundred people.	Ꮲ ᏍᎪᎯᏥᏍᏆ ᎾᏂᎥ ᏴᏫ.
The children want to play ball.	Ꮎ ᏗᏂᏲᏟ ᏍᏆᎴᏍᏗ ᏧᎾᏁᎶᏗ ᎤᎾᏚᎵᎭ.
He went to New Mexico while on his vacation.	ᏍᏆᏂᏤᏍᏛ ᏭᏪᏙᎸ ᏙᎢ ᎡᏙᎲ ᎢᎪᎯᏓ.
The boys fought with their fists.	ᏗᏍᏇᏅ ᎬᏗ ᎤᎾᏟᎸ ᎠᏂᏧᏣ.
I am working today, and I will work tomorrow also.	ᎪᎯ ᎢᎦ ᏓᎩᎸᏫᏍᏓᏁᎭ, ᏑᎾᎴᏅ ᎥᏍᏊ ᏙᏛᎩᎸᏫᏍᏓᏁᎵ.
Isn't he back yet?	ᏝᏍ Ꮟ ᏱᎦᎷᎦ?
He went to his sister's home for one day.	ᏏᎦ ᏭᏪᏙᎸ ᎤᏙ ᏧᏪᏅᏒᎢ.
I hear katydids.	ᏍᎩᎩ ᎾᏂᏪᏍᎬ ᎦᏛᎩᎠ.
I heard yesterday that he was supposed to speak again today. I want more water.	ᏒᎯ ᎠᏆᏛᎦᏅ ᏏᏊ ᏗᎦᏬᏂᏏᏒ ᎪᎯ ᎢᎦ. ᏏᏊ ᎠᏆᏚᎵ ᎠᎹ.
How much does that pig weigh?	ᎯᎳ ᎢᏳᏓᎨᏓ Ꮎ ᏏᏆ?
A new car is better than an old one.	ᎢᏤ ᏓᏆᏪᎳ ᏓᏤᏝ ᏏᏅ ᎤᏪᏘ ᎨᏒᎢ.
They took one month in building the house.	ᏏᏅᏓ ᎤᏂᎯᎵᏙᎸ ᎦᎵᏦᏕ ᎠᏀᏁᏍᎨᏍᎬᎢ.
He's standing on the other side fishing.	ᏍᎪᏂ ᏗᎦᏙᎦ ᏗᏑᎲᏍᎦ.
Did you have to go overseas when you were in the service?	ᏍᎪᏂᏱᏍ ᏫᏤᏓᏍᏗ ᏄᎵᏍᏔᏁ ᎠᏂᏲᏍᎩ ᏥᏯᎥᎢ?
They're racing horses.	ᏐᏈᎵ ᏓᎾᏙᎩᏯᏍᏗᎭ.
He's plowing with a mule.	ᏐᏈᎵ ᏗᎦᎴᏅᎢᏓ ᎬᏗ ᎦᏓᎷᎩᎠ.
He picks hickory nuts in the fall.	ᏐᎯ ᏕᎫᎡᏍᎪ ᎤᎵᎪᎲᏍᏗ.
I have to see the doctor tomorrow at nine o'clock.	ᏐᏁᎳ ᎢᏳᏩᏂᎸ ᏑᎾᎴ ᏥᎪᏮᏛᏗ ᎦᎾᎦᏘ.
Do you want to be the ninth?	ᏐᏁᎵᏁᎢᏍ ᏱᏣᎵᏍᏙᏗ ᏣᏚᎵᎭ?
He went in another room. Give me another one.	ᏐᎢ ᏗᎧᏅᏑᎸ ᏩᏴᎭ. ᏏᏊ ᏐᎢ ᏥᏍᎬᏏ.
Set this chair in the next room.	ᏐᎢᏱ ᏫᏍᎩᎳᏓ ᎯᎠ ᎦᏍᎩᎶ.
I want to say one thing.	ᏑᏓᎴᎩ ᎢᏯᎩᏪᏍᏗ ᎠᏆᏚᎵ.
The alarm clock wakes him up at six o'clock in the morning.	ᏑᏓᎵ ᎢᏳᏩᏂᎸ ᏑᎾᎴ ᏗᏜ ᎤᏰᎢᏍᏙᏍᎪᎢ ᏩᏥ.
He hasn't been here since the sixth of last month.	ᏑᏓᎵᏁ ᏐᎢ ᏥᎧᎸ ᎬᏪᏙᎸᎢ.
I bought this watch one year ago.	ᏑᏕᏘᏴᏓ ᏥᎨᏒᎥ ᏣᎩᏩᏒ ᎯᎠ ᏩᏥ.
After she made the dough, she put it in the oven.	ᏑᎨᏓ ᎤᏬᏢᏃᎿ, ᏗᎦᏘᏗ ᏭᏝᏅᎢ.
I want two fishhooks.	ᏔᎵᎭ ᏗᏑᏗ ᏓᏆᏚᎵᎭ.
It took him two hours to pick a gallon of blackberries.	ᏔᎵ ᎢᏳᏟᎶᏓ ᎤᎯᎵᏙᎸ ᏑᏟᎶᏓ ᎧᏄᎦᏟ ᎦᏕᏍᎬᎢ.
The buzzards are eating something dead.	ᎪᎱᏍᏗ ᎤᎵᏬᏨ ᎠᏂᏰᎠ ᏑᎵ.
Our meeting is scheduled for tomorrow at two o'clock.	ᏑᎾᎴ ᏔᎵ ᏳᏩᏂᎸ ᏥᎨᏎᏍᏗ ᏓᏒᏍᏗ ᏗᎦᏠᎯᏍᏗᎢ.
Come in the morning.	ᏑᎾᎴ ᏗᏜ ᎯᎷᏨᎢ.
I'll see you tomorrow evening.	ᏑᎾᎴ ᏒᎯᏰᏱ ᎢᎬᎪᎥᎢ.
Stay overnight the next time you come.	ᏑᏒᎯᏓ ᎮᏙᎸ ᏔᎵᏁᎢ ᎢᏁᏙᎸᎢ.
The barrel filled up with rainwater when it rained.	ᏒᏙᏂ ᎤᎧᎵᏨ ᎤᎦᎿᏅ ᎠᎹ ᎤᎦᎿᎾ.
When she peels onions it makes her cry.	ᏒᎩ ᏱᏚᏁᎦᎸᎭ ᎤᏠᏱᏍᏗᏍᎪᎢ.
Where were you yesterday?	ᎭᏢ ᎮᏙᎮ ᏒᎯ ᏥᎨᏒᎢ?
I came over for a while yesterday morning.	ᏒᎯ ᏑᎾᎴ ᏥᎨᏒ ᏞᎦ ᎠᏇᏙᎸᎢ.
I finished bailing hay yesterday evening.	ᏒᎯ ᏒᎯᏰᏱ ᎠᏱᏍᏆᏛ ᎧᏁᏍᎦ ᏕᏥᏍᏓᏴᏗᏍᎬᎢ.
Did it rain night before last?	ᎤᎦᎿᏁᎢᏍ ᏒᎯ ᎤᏒᎢ?
He mows the grass in the evening.	ᏒᎯᏰᏱ ᎠᎦᎵᏍᎪ ᎦᏄᎸ.
He bought some apples in town.	ᏒᎦᏔ ᏚᏩᏒ ᏗᎦᏚᎲᎢ.
One week is not long.	ᏒᎾᏙᏓᏆᏍᏗ Ꮭ ᎪᎯᏓ ᏱᎨᏐᎢ.
At midnight I will leave.	ᏒᏃᏱ ᎠᏰᏟ ᏓᎦᏁᎳᏗ.
He bought two pairs of shoes.	ᏔᎵ ᎢᏗᎳᏑᎶ ᏚᏩᎯ.
My birthday is on April second.	ᎧᏬᏂ ᏔᎵᏁ ᎠᏆᏕᏘᏱᏍᎩ.
Are you going to work on Tuesday?	ᏙᏓᏣᎸᏫᏍᏓᏁᎵᏍ ᏔᎵᏁ ᎢᎦ?
Cans get rusty if water is left in them too long.	ᏓᏯᏍᎳᏗᏍᎪ ᏔᎷᎩᏍᎩ ᏯᎪᎯᎳ ᎠᎹ ᏱᏓᎵᏍᏗ.
Is your brother a welder?	ᏔᎷᎩᏍᎩᏍ ᏗᎧᏅᏫᏍᎩ ᏚᏍᏓᏓᏅᏟ?
He ran out of solder.	ᏔᎷᎩᏍᎩ ᏗᎧᏅᏬᏙᎯ ᎤᏨᎲᏏ.
What do you make baskets out of?	ᎦᏙ ᎤᏍᏗ ᏕᎰᏢᏗᏍᎪ ᏗᏔᎷᏣ?
How many tomatoes do you want?	ᎯᎳ ᎢᎦ ᏔᎹᏟ ᏕᏣᏚᎵᎭ?
A hawk is sitting on a post.	ᎨᏛ ᎤᎩᎳ ᏔᏬᏗ.
You can see a lot of toads by a pond.	ᎥᏓᎷᎵᏗ ᏥᏍᏈᏍᏗ ᏱᏛᎪᏩᏔ ᏖᎦ.
If people don't wash their hair, they get lice.	ᏴᏫ ᎾᎾᎵᏍᏚᎴᏍᎬᎾ ᏱᎩ ᏘᎾ ᎬᏩᏂᎸᎪᎢ.
A blacksnake caught a lizard.	ᏘᏲᎭᎵ ᎦᏂᏯ ᎦᎴᎩ.
Have you ever seen an eel?	ᎢᎸᎯᏳᎢᏍ ᎯᎪᎥ ᏢᏕᏆ?
I heard that you weren't well.	ᏙᎯ ᏂᎨᏒᎾ ᎨᏒ ᎬᏯᏛᎦᏅ.
I am just fine, and you?	ᏙᎯᏊ ᎠᏴ, ᏂᎯᎾ?
When he told them to be still, they became quiet.	Ꮩ ᏂᏣᏛᎦ ᏚᏬᏎᎳ, ᎡᏝᏪ ᏄᎾᎵᏍᏔᏅᎢ.
The redbird is smaller than the bluejay.	ᏙᏧᏮᎠ ᎤᏍᏗᎧ ᏏᏅ Ꮎ ᏜᏴᎦ ᎨᏒᎢ.
In the summer you can see a lot of grasshoppers.	ᎪᎩ ᏥᏍᏈᏍᏗ ᏗᎪᏮᏛᏗ ᏙᎳᏥᎦ.
Do you believe there are ghosts?	ᏦᎯᏳᎭᏍ ᎠᏂᏥᎩᎵ ᎠᏁᎲ?
Look! There's a bug on the bush.	Ꮒ! ᏥᎪᏯ ᎤᎩᎳ ᎤᏩᎢᏢᎢ.
I hear a whippoorwill every night close to the house.	ᏥᏆᎴᏆᎳ ᏂᎦᏪᏍᎬ ᎦᏛᎩᏍᎪ ᏧᎵᏏᏅᏓ ᎠᏓᏁᎸ ᎾᎥᎢ.
She talks a lot when she feels well. I see many white men.	ᏥᏈᏍᏗ ᎦᏬᏂᏍᎪ ᎣᏍᏓ ᏳᏓᏅᏔ. ᏥᏈᏍᏗ ᎠᏂᏲᏁᎦ ᎦᏥᎪᏮᏘᎭ.
She had her tonsils taken out at the hospital.	ᏚᎴᏥ ᏂᏓᎬᏅᏓᎡᎸ ᏧᏂᏢᎩᎢ.
He's putting medicine on his boil.	ᏅᏬᏘ ᎦᏅᎵᏰᎠ ᏚᏍᏗ ᎤᏜᎥᎢ.
What kind of beans are these?	ᎦᏙ ᎤᎾᏍᏗ ᏚᏯ ᎯᎠ?
Close the door, you're letting the flies in.	ᎯᏍᏚᎲᎦ ᎦᎶᎯᏍᏗᎢ, ᏛᎦ ᏕᎯᏴᏗᎭ.
He was asked to pray.	ᎤᏓᏙᎵᏍᏙᏗ ᎠᏥᏔᏲᏎᎸᎢ.
I guess he really loved her.	ᎤᏙᎯᏳ ᎠᏎ ᎤᏓᎨᏳᏎᎢ.
I didn't know he was an ordained minister.	Ꮭ ᏯᏆᏅᏖ ᎤᏓᏂᎳᎨ ᎨᏒᎢ.
Which is the oldest one?	ᎦᏙ ᎤᏍᏗ ᏥᎩ ᎤᏓᏂᎳᎨᎢ?
He's really a reckless boy.	ᎤᏙᎯᏳ ᎤᏓᏣᏘᏗ ᎠᏧᏣ.
Cherokees say that if you hear a crow at night, it's a bad omen.	ᎪᎦ ᏂᎦᏪᏍᎬ ᏯᏛᎦᎾ ᎤᏒ, ᎤᏓᎴᎯ ᎠᎾᏗᏍᎪ ᎠᏂᏣᎳᎩ.
His wife is my cousin.	ᎤᏓᎵᎢ ᎪᎱᏍᏗ ᎠᏋᏂ.
That boy is really snobbish.	ᎤᏙᎯᏳ ᎤᏓᎸᏉᏗ Ꮎ ᎠᏧᏣ.
What did the store owner give you?	ᎦᏙ ᎤᏍᏗ ᏨᏏ Ꮎ ᎤᏓᎾᏂ?
The old woman's skin is wrinkled.	Ꮎ ᎠᎦᏴᎵᎨ ᎤᏁᎦᎸ ᎤᏓᏁᎪᏳᎭ.
A bird is bathing in a puddle of water.	ᎠᎹ ᎤᏓᏁᎲ ᎠᏓᏬᎠ ᏥᏍᏆ.
His heart stopped on him.	ᎤᏓᏅᏙ ᎤᎴᏫᏍᏓᏁᎸᎢ.
I feel all right now.	ᎣᏏᏊᏛ ᎠᏆᏓᏅᏔ ᏃᏊ.
He is very pleasant to talk with.	ᎤᏙᏳ ᎤᏓᏅᏘ ᎠᏟᏃᎮᏙᏗ.
He has a tamed raccoon.	ᎤᏓᏅᏘᏌᏅ ᎬᏟ ᎤᎾᏝᎠ.
He always keeps his room clean.	ᏂᎪᎯᎸ ᎤᏓᏅᎦᎸᏓ ᏄᏩᏃ ᎤᏴᏍᏗᎢ.
He walked a long way.	ᎤᏓᏅᎯᏓ ᎡᎳᏗ ᎤᏂᎩᏒᎢ.
He's walking between two rows of potatoes.	ᏄᎾ ᏚᏓᏅᏅ ᎠᏰᏟ ᎠᎢ.
Breaking the law leads to punishment.	ᎤᏓᏍᏛᏗᏍᏗ ᎨᏒ ᏩᏟᎢᎶᎯᎭ ᏱᏛᏲᏍᏗ ᏗᎧᏃᏩᏛᏍᏗ.
The workers are resting in the shade.	ᎤᏓᏩᏗᏍᎬ ᎤᎾᏓᏪᏐᎸᏍᏗ ᏧᏂᎸᏫᏍᏓᏁᎯ.
Something is in view in the bushes.	ᎪᎱᏍᏗ ᎤᏓᏴᎳᏔ ᏚᏩᎢᏢᎢ.
Tomorrow throw the trash away.	ᏑᎾᎴ ᎤᏟ ᏫᏣᏕᏒ Ꮎ ᎤᏲ ᎦᎵᏛᎢ.
How many pitchers do you all have?	ᎯᎳ ᎾᏂᎠ ᎤᎾᏕᎩ ᏕᏥᎧᎭ?
He's causing embarrassment by doing that.	ᎤᏕᎰᎯᏍᏗ ᎪᏢᏍᎦ ᏥᎾᏛᏁᎭ.
She has a bashful boy.	ᎤᏕᎰᏌᏘ ᎠᏧᏣ ᎤᏩᎧᎭ.
Can you help me get my car out of a ditch?	ᎡᎵᏊᏍ ᏱᏍᎩᏍᏕᎳ ᎤᏕᎵᏍᎦᎸᎲ ᎦᎴᏒ ᏓᏆᎴᎳ?
Today my brother is having a birthday.	ᎪᎯ ᎢᎦ ᎤᏕᏘᏱᎭ ᏦᏍᏓᏓᏅᏟ.
Tighten those bolts.	ᏘᏍᏓᏱᏓ Ꮎ ᏧᏗᏆᎸᏕᏱᏓ.
It's really hot today.	ᏙᏳ ᎤᏗᏞᎦ ᎪᎯ ᎢᎦ.
The patient had a high fever.	Ꮎ ᎤᏢᎩ ᏥᏈᏍᏗ ᎤᏗᏞᎲᏍᎬᎢ.
Where is he hiding?	ᎭᏢ ᎤᏗᏍᎦᏝ?
When he got some medicine, he got well fast.	ᏅᏬᏘ ᎤᎩᏌ, ᎦᏣᏄᎵ ᎤᏗᏫᏒᎢ.
His shirt was so small his navel was showing.	ᎤᏍᏗᎩ ᎤᏄᏮ ᎢᏳᏍᏗ ᎤᏗᏴᏓᏛ ᎤᎦᏌᏛᎢ.
There is a job opening at the clothing manufacturers.	ᏗᎿᏬ ᏧᏃᏢᏗ ᎤᏜᏅᏓ ᏗᎦᎸᏫᏍᏓᏁᏗᎢ.
I'll have time to come to visit you next month.	ᏐᎢ ᎧᎴᏍᏗ ᎠᏆᏜᏅᏓᏕᎮᏍᏗ ᏫᎬᏩᏛᎯᏓᏍᏗᎢ.
Don't you believe I can do it?	ᏣᏜᏏᏛᎡᎭᏍ ᎡᎵᏊ ᏱᎬᏆᏛᏁᏗ ᎨᏒᎢ?
How many nonbelievers are here?	ᎯᎳ ᎾᏂᎠ ᎤᎾᏜᏏᏛᎡᎯ ᎠᏁᏙᎭ?
He took revenge when he was cheated.	ᎤᏞᏨ ᎠᏥᎶᏄᎡᏝ.
Go away.	ᎤᏟ ᏫᎶᎯ.
She's wearing earrings made of gold.	ᎠᏕᎳ ᏓᎶᏂᎨ ᏗᎪᏢᏔᏅ ᏗᏟᎠᏙ ᏚᏟᎠᏓ.
Who would admit that he's a hypocrite?	ᎦᎪ ᏱᎪᎯᏳᏓ ᎤᏠᎾᏍᏗ ᎨᏒᎢ?
Dewberries are similar to blackberries.	ᎤᏠᏏᏅᏗ ᏥᎩ ᎧᏄᎦᏟ ᎤᏠᏱᎨᎢᏍᏗ.
A splinter from a board stuck him in his foot.	ᏯᏖᎾ ᎤᏢᏓᎸᏓ ᎤᏣᏲᎭ ᎤᎳᏏᏕᏂ.
I was sick yesterday, but I'm all right today.	ᏒᎯ ᏥᎨᏒ ᎠᎩᏢᎬ ᎠᏎᏅ ᎣᏏᏊ ᎢᎩ ᎪᎯ ᎢᎦ.
How many patients are in this hospital?	ᎯᎳ ᎢᏯᏂᎢ ᏧᏂᏢᎩ ᎠᏂᏯᎠ ᎠᎭᏂ ᏧᏂᏢᎩᎢ?
That man acts sophisticated.	Ꮎ ᎠᏍᎦᏯ ᎤᏢᏈᏗ ᎤᏤᎸᏐᎢ.
Her brother is visiting her for one week.	ᎤᏙ ᎤᏩᏛᎯᏙᎭ ᏒᎾᏙᏓᏆᏍᏗ ᎢᎪᎯᏓ.
What does her father do?	ᎦᏙ ᎠᏛᏁᎯ ᎤᏙᏓ?
He hunts all day when he goes hunting.	ᎤᏙᏓᏆᏓ ᎦᏃᎭᎵᏙᎰ ᏳᏃᎭᎴᎾ.
Do you go to church on Sunday?	ᏕᎯᎳᏫᏤᎪᎢᏍ ᎤᎾᏙᏓᏆᏍᎬ ᎢᎦ?
Sometimes I work on Saturday.	ᎢᏴᏓᎭ ᎤᎾᏙᏓᏈᏕᎾ ᏓᎩᎸᏫᏍᏓᏁᎰᎢ.
He's coming sometime during the day.	Ꮲ ᎤᏙᏓᏈᏗᏒ ᏓᎦᎷᏥ.
They're going to start school Monday.	ᎤᎾᏙᏓᏉᏅ ᏛᎾᎴᏅᎯ ᏓᎾᏕᏠᏆᏍᎬᎢ.
You did very well on your exam.	ᎤᏙᎯᏳ ᎣᏍᏓ ᎿᏛᎦ ᎡᏣᎪᎵᏰᏍᎬᎢ.
The boy is listening to his grandfather tell stories.	ᎤᏚᏚ ᎧᏃᎮᏢᏍᎬ ᎤᏛᏓᏍᏗ ᎠᏧᏣ.
I am standing in the water.	ᎠᎹᏱ ᎠᏆᏚᎭ.
What's his uncle's name?	ᎦᏙ ᏚᏙᎠ ᎤᏚᏥ?
He wants to rest.	ᎤᏓᏪᏐᎸᏍᏙᏗ ᎤᏚᎵᎭ.
He's willing to help anytime.	ᏱᏂᎦᎵᏍᏗᎭᏊ ᎢᏴ ᎤᏛᏅᎢᏍᏙ ᎤᏓᏍᏕᎸᏗᎢ.
In the fall the leaves will turn into different colors.	ᎤᎵᎪᎲᏍᏗ ᎢᏴ ᏧᎦᎶᎦ ᏧᏓᎴᏅᏓ ᏧᎵᏑᏫᏓ ᏂᏙᏓᎦᎵᏍᏔᏂ.
What kind of soup do you want?	ᎦᏙ ᎤᏍᏗ ᎤᎦᎹ ᏣᏚᎵᎭ?
These cantaloupes are really sweet.	ᏙᏳ ᎤᏂᎦᎾᏍᏓ ᎯᎠ ᎠᏂᏩᏒᎩ.
It sure got warm today, didn't it?	ᎤᏙᎯᏳ ᎤᎦᎾᏩ ᏂᎦᎵᏍᏓ ᎪᎯ ᎢᎦ, ᏙᎧ?
Is the candidate wo is speaking a Democrat?	ᎤᎦᎾᏩᏍ Ꮎ ᎠᏙᎩᏯᏍᎩ ᏥᎦᏬᏂᎭ?
I am getting warm a little now. He's sitting by the stove warming himself.	ᎠᎩᎦᎾᏬᏍᎦᏛ ᏍᏗᎩᏓ ᏃᏊ. ᎣᏏ ᎾᎥ ᎤᏬᏝ ᎤᎦᎾᏬᏍᎦ.
The song is on the second page.	ᏔᎵᏁ ᎤᎦᏅᏓᏛ ᎪᏪᎳ ᎧᏃᎩᏍᏗ.
He's stingy with his watch and won't loan it to anyone. Love your wife.	ᎤᎨᏳᎭ ᏩᏥ ᏝᎴ ᎩᎶ ᏴᎬᏙᎵᏍᏓ. ᎯᎨᏳᏎᏍᏗ ᏣᏍᏓᏴᎲᏍᎩ. 
That man is really stingy.	ᎤᏙᎯᏳ ᎤᎨᏳᎿ Ꮎ ᎠᏍᎦᏯ.
Indians wear feathers on their heads.	ᎠᏂᏴᏫᏯ ᏧᎩᏓᏟ ᏚᎾᏗᎵᎪᎢ.
I din't get there until the next morning.	ᎤᎩᏨᏓ ᎢᏴ ᎩᎳ ᏩᎩᎷᏨᎢ.
He gets up at dawn when he has to work.	ᎤᎩᏥᏕᏱ ᎠᏗᏗᏍᎪ ᏧᎸᏫᏍᏓᏁᏗ ᏱᎩ.
Which one do you like more?	ᎦᏙ ᎤᏍᏗ ᎤᎪᏗ ᏣᎸᏉᏗ?
She sells a lot of milk.	ᎤᎪᏗ ᎤᏅᏗ ᎦᎾᏕᎪᎢ.
If you wait too long to go, you'll be late.	ᎪᎯᏗᏍ ᎢᎯᎦᏘᏰᏍᏗ ᏤᏅᏍᏗ ᏓᏣᎪᏂᏲᏥ.
The old wood is decaying.	ᎠᏓ ᎤᏪᏘ ᎤᎪᏍᎦ.
I small something rotten.	ᎪᎱᏍᏗ ᎤᎪᏏᏓ ᎠᎩᏩᏒᎦ.
Some people think it is a bad omen to hear a hoot owl close to a building.	ᎢᎦᏓ ᎤᏓᎴᎯ ᎠᏁᎵᏍᎪ ᎤᎫᎫ ᏱᏂᎦᏪᎠ ᎠᏓᏁᎸ ᎾᎥᎢ.
Is that man part Cherokee?	ᏣᎳᎩᏍ ᎤᎬᎭᏟ Ꮎ ᎠᏍᎦᏯ?
I want money instead.	ᎠᏕᎳ ᎤᎬᏫᏳ ᏓᏆᏚᎵᎭ.
Does the chief know you?	ᏦᎵᎩᏍ ᎤᎬᏫᏳᎯ?
He has ten acres of land.	ᏍᎪᎯ ᎢᏳᏟᎶᏓ ᎦᏓ ᎤᎭ.
He's yawning because he's sleepy.	ᎤᎭᏠᎨ ᎦᏢᏍᎬ ᎢᏳᏍᏗ.
I hear a bell ringing.	ᎤᎭᎸᏂ ᎤᏃᏴᎬ ᎦᏛᎩᎠ.
His lips are getting dry.	ᏚᎭᏁᎦᎸ ᏚᎧᏲᎯᏎᎭ.
``	ᏦᎳᏂ ᎯᏍᏚᎢ. ᎠᎧᏬᏍᏗᎭ.
There's dew on the ground	ᎦᏙᎯ ᎤᎯᏌᏔ.
She doesn’t like to get lonesome.	Ꮭ ᏳᎸᏉᏗ ᎤᎯᏐᏓᏁᏗ.
It was lonesome when she left.	ᎤᎯᏐᏛ ᎤᏁᎳᏓ.
He became strong by lifting weights.	ᏗᎦᎨᏓ ᏓᏌᎳᏗᏍᎬ ᎤᏟᏂᎩᏓ ᏄᎵᏍᏔᏅᎢ.
Write their names down quickly.	ᏚᎾᏙᎥ ᏙᏪᎸᎦ ᎤᏟᏍᏓ.
Where does her aunt live?	ᎭᏢ ᏫᎦᏁᎳ ᎤᏠᎩ?
I want the same kind of car he has.	ᏓᏆᎴᎳ ᎤᎲ ᎤᏠᏱ ᎠᏆᏚᎵᎭ.
Are you going there?	ᎤᎿᏍ ᏖᏏ?
Some islands are small.	ᎢᎦᏓ ᏚᎿᎷᏛ ᏧᏍᏗ ᎨᏐᎢ.
Leave the dog alone because he's getting mad.	ᏁᎳᎩ ᎩᏟ ᎤᎿᎸᎦᏏ.
The man is always angry.	Ꮎ ᎠᏍᎦᏯ ᏂᎪᎯᎸ ᎤᎿᎸᏐᎢ.
He's drinking tea made from sassafras root.	ᎧᎾᏍᏓᏥ ᎤᎿᏍᏕᏜ ᎠᎦᏅ ᎠᏗᏔᏍᎦ.
Don't chop on the tree roots.	ᏞᏍᏗ ᏕᏡᎬ ᏚᎿᏍᏕᏢ ᏱᏘᎷᏯᏍᎨᏍᏗ.
He stubbed his toe on a big rock.	ᏅᏯ ᎤᏔᎾ ᎠᎲ ᎤᎿᏍᏆᎶᎥᎢ.
She's picking some possum grapes.	ᎤᏂᎿᏑᎦ ᏕᎦᏕᎠ.
He's trimming his toenails with a knife.	ᎭᏰᎵᏍᏗ ᎬᏗ ᏓᏍᏆᎸᏍᎦ ᏚᎿᏑᎦᏢᎢ.
This patient has a chill.	ᎯᎠ ᎤᏢᎩ ᎤᎿᏩᏍᏗᎭ.
He tore his shirt going under a fence.	ᎤᎿᏬ ᎠᏲᏍᏓ ᎠᏏᎳᏛ ᎦᏄᏴᎯᎲᎢ.
He doesn't like for anyone to see his scar.	Ꮭ ᏳᎸᏉᏗ ᎩᎶ ᎤᎪᏩᏛᏗ ᎤᏁᎸᏒᎢ.
Are you already in bed?	ᎦᏳᎳᏍ ᏣᏂᎭ?
A stump is all that's left of the big tree.	ᎤᏂᏡᎬᎢᏊ ᎢᎦ ᎤᏟᏃᎯᏯ Ꮎ ᎤᏔᎾ ᏥᏡᎬᎢ.
He charges one dollar when he fixes a tire.	ᎤᏃᏍᏓ ᏓᎬᏩᎶᏗᏍᎪ ᎠᏢᏗ ᎣᏍᏓ ᏱᏄᏩᏁᎳ.
Soldiers wear uniforms.	ᏧᏠᏱᎭ ᏚᏀᏄᏬ ᎠᏂᏲᏍᎩ
The rainbow faded when the cloud cleared up.	ᎤᏅᏉᎳᏛ ᎤᏍᎪᎸᏨ ᎤᎶᎩᎸ ᎤᎵᎦᎵᏴᎭ.
Go stand in the corner.	ᎤᏅᏏᏴ ᏩᎴᎲᎦ.
He took some thick clothing when he went up north.	ᏧᏩᎨᏓ ᏗᎿᏬ ᏚᏅᏒ ᏧᏴᏢ ᎤᏪᎾ.
Yesterday I bought a car.	ᏒᎯ ᏥᎨᏒ ᏓᏆᎴᎳ ᎠᎩᏩᏒᎢ.
That woman's husband is looking for her.	Ꮎ ᎠᎨᏯ ᎤᏰᎢ ᎤᏲᎭ.
He is looking for the watch he lost yesterday.	ᏩᏥ ᏧᏲᎱᏎᎸ ᏒᎯ ᎤᏲᎭ.
What's floating on the water?	ᎦᏙ ᎤᏍᏗ ᎤᏲᎷᎭ ᎠᎹᏱ?
He has a big horn on his car.	ᎤᏔᎾ ᎤᏲᎾ ᏄᏩᏅᏗ ᏓᏆᎴᎷᎢ.
Whenever a Cherokee "catches" a cold, he doesn't catch the cold; rather, the cold catches him.	ᎠᏣᎳᎩ ᎤᏴᏜ "ᏳᏂᏴᎭ" Ꮭ ᎤᏴᏜ ᏱᎦᏂᏱᏍᎪᎢ, ᎤᏴᏜᏍᎩᏂ ᎤᎬᏫᏍᏳᏐ ᎤᏂᏱᏍᎪᎢ.
I'm thirsty for cold water.	ᎤᏴᏜ ᎠᎹ ᎠᎩᏔᏕᎩᎠ.
Do you vote Republican?	ᎤᏴᏜᏍ ᎯᏁᎩ?
It's really cold outside.	ᏙᎯᏳ ᎤᏴᏜ ᏙᏱ.
I don't feel good. I have a cold.	Ꮭ ᎣᏍᏓ ᏯᏆᏓᏅᏔ. ᎤᏴᏜ ᎠᎩᏂᏱᎭ.
Don't choke on it.	ᏞᏍᏗ ᏥᏣᏴᏥᏅᏘᏏ.
How many did he drink before he got drunk?	ᎯᎳ ᎢᎦ ᏚᏗᏔᎮ ᎩᎳ ᎤᏴᏍᏓᎡᎢ?
I see a drunk man waling this way.	ᎤᏴᏍᏕᏓ ᎠᏍᎦᏯ ᏣᎢᏒ ᏥᎪᏩᏘᎭ.
Some drunkard froze to death last winter.	ᎩᎶ ᎤᏴᏍᏕᏍᎩ ᎤᎿᏬᏨ ᎪᎳ ᏥᎨᏒᎢ.
He likes to drink strong coffee.	ᎤᏴᏍᏗ ᎧᏫ ᎤᏗᏔᏍᏗ ᎤᎸᏉᏗ.
The cat is inside the box.	ᏪᏌ ᎧᏁᏌᎢ ᎤᏣᎠ.
They make bread out of wheat.	ᎦᏚ ᎠᏃᏢᏗᏍᎪ ᎤᏣᎴᏍᏗ.
A drunk was arrested amon a lot of people.	ᎤᏂᏣᏘ ᏄᎾᏛᏅ ᏴᏫ ᎠᏥᏂᏴᎲ ᎤᏴᏍᏕᏓ.
His car is red.	ᎩᎦᎨ ᎤᎵᏑᏫᏓ ᏓᏆᎴᎳ ᎤᏤᎵᎢ.
When you say something to him, he grins.	ᎪᏍᏗ ᏱᎪᏎᎳ ᎠᏤᏥᏍᏗᏍᎪᎢ.
I ran over a possum last night.	ᎤᏤᏥᏍᏗ ᏥᏯᏗᏅᏔᏅ ᎤᏒ ᏥᎨᏒᎢ.
Doesn't he hear his mother calling him?	ᏝᏍ ᏯᏛᎩᎠ ᎤᏥ ᏧᏯᏂᏍᎬᎢ?
Have you ever picked cotton?	ᎢᎸᎯᏳᎢᏍ ᎤᏥᎸ ᏣᏕᏓ?
Some fishermen use worms when they fish.	ᎢᎦᏓ ᎠᎾᏑᏂᏙᎯ ᎤᏂᏥᏯ ᏓᏅᏗᏍᎪ ᏳᎾᏑᎿ.
When he heard a snake rattling, he froze.	ᎢᎾᏓ ᎤᏦᎾᏛ ᎤᏛᎦᎾ ᎤᏯᏅᏒᎢ.
Rattlesnakes live in that cave over there.	ᎤᎾᏦᎾᏘ ᎠᏂᏁᎳ ᎠᎨ ᏥᏧᏍᏓᎦᎳ.
His handwriting is confusing.	ᎤᏦᏍᏗ ᏚᏬᏪᎳ.
Although it rained yesterday, the ground is already dry.	ᏁᎳᎩ ᏧᎦᎿᏅ ᏒᎯ, ᎦᏳᎳ ᎤᎧᏲᏓ ᎢᎩ ᎦᏙᎯ.
Walk on a dry place.	ᎤᎧᏲᏛ ᎭᎢᏎᏍᏗ.
His face is just hot.	ᎤᏗᎴᎩᏊ ᎤᎧᏛᎢ.
His house is in the valley.	ᎤᎨᏓᎵᏴ ᎠᏓᏁᎳ ᏧᏪᏅᏒᎢ.
What's that sticking out of your pocket?	ᎦᏙ ᎤᏍᏗ ᎤᎧᏌᏔ ᏣᎳᏩᏛᎢ?
He's watching a prisoner so he won't get away.	ᎠᏴᎩ ᎤᎦᏎᏍᏗ ᎤᎵᏘᏍᏗ ᏂᎨᏒᏅ ᎤᎡᎸᏒᎢ.
What do goats eat?	ᎦᏙ ᎤᏍᏗ ᎠᏂᎩᏍᎪ ᎤᎾᎦᏐᏣᏁᏓ?
Diamondback rattlers are dangerous.	ᎤᎾᎦᏑᏘ ᎠᏂᎾᏰᎩ.
She saves watermelon seeds.	ᎬᎩᏍᏗ ᎤᏂᎩᏔ ᏓᎵᏏᏅᏗᏍᎪᎢ.
It was foggy this morning.	ᎤᎬᎭᏓ ᎪᎯ ᏑᎾᎴᎢ.
Kittens are cute.	ᏪᏌ ᎠᏂᏓ ᎤᏂᎬᎯᏍᏓ ᎨᏐᎢ.
He went deer hunting yesterday but he had no luck. 	ᎠᏫ ᏚᏯᎸᏒ ᏒᎯ ᎠᏎᏅ ᎤᏉᎸᏒᎢ.
His feet are sticking out from under his covers.	ᏧᎳᏏᏕᏂ ᏚᎦᏌᏔ ᏚᎿᏬᏍᏛᎢ.
He's lacing up his shoes.	ᏧᎳᏑᎶ ᏕᎧᎸᏌᏛᏍᎦ.
He got lost because he didn't know which way to go.	ᎤᎴᏀᎸ ᏝᎮᏃ ᏯᎧᏔᎮ ᎢᏗᏜ ᏭᎶᎯᏍᏗᎢ.
He became skinny because he was sick for a long time.	ᎪᎯᏓ ᎤᏢᏨ ᎢᏳᏍᏗ ᎤᎴᏐᏓ ᏄᎵᏍᏔᏅᎢ.
You'll be making a mistake if you say that.	ᏣᎵᏓᏍᏗᏍᎨᏍᏗ ᎥᏍᎩ ᏂᎯᏪᏒᎢ.
He's going to school in the fall.	ᎤᎵᎪᎲᏍᏗ ᎢᏴ ᏛᎴᏅᎯ ᏓᏕᎶᏆᏍᎬᎢ.
Is that snake dead?	ᎤᎵᏬᏨᎢᏍ Ꮎ ᎢᎾᏓ?
My brother has curly hair.	ᏦᏍᏓᏓᏅᏟ ᎤᎵᏥᏍᏆᏁᏓ ᎤᏍᏘᎦ.
He's taking the fat off the meat.	ᎤᎵᏦᎯᏓ ᏂᎬᏅᏕ ᎭᏫᏲᎯ.
She's cleaning some hog intestines.	ᏏᏆ ᏧᎵᎩᏏ ᏕᎦᏅᎦᎵᎭ
He's not too weak.	Ꮭ ᎤᏙᎯᏳ ᎤᎵᏍᏗ ᏱᎩ.
His grandmother gave him a coat.	ᎤᎵᏏ ᎤᏅᏁᎸ ᎦᏌᎴᏂ.
Why is he moaning?	ᎦᏙ ᏧᎵᏰᏗᎭ?
She was wearing a wedding ring.	ᏕᎨᎦᏨᏍᏗᏍᎬ ᎤᎾᎵᏰᏑᏍᏙᏗ ᎠᎵᏰᏑᏍᏙ ᎤᎵᏰᏑᏍᏘᎬᎢ.
It's cloudy like it's going to rain.	ᎤᎦᎿᏂᏕᎾ ᎢᏳᏍᏗ ᎤᎶᎩᎳ.
The clouds are moving fast.	ᎦᏣᏄᎵ ᎠᎢ ᎤᎶᎩᎵ.
Something happened to him while he was away. He didn't come back. What's wrong with that dog?	ᎪᏍᏗ ᎤᎵᏍᏓᏁᎸ Ꮲ ᏪᏙᎲ. Ꮭ ᏱᎤᎷᏤᎢ. ᎦᏙ ᎤᎵᏍᏓᏁ Ꮎ ᎩᏟ?
When I found out the door was open, I went in.	ᎦᎶᎯᏍᏗ ᎤᎵᏍᏚᎢᏓ ᎨᏒ ᎠᏆᏕᎶᎰᏌ, ᏩᎩᏴᎸᎢ.
Those ball players are wearing new caps.	Ꮎ ᎠᎾᎳᏍᎦᎵᏍᎩ ᏗᏤ ᏚᎾᎵᏍᏚᎳ.
I guess it wasn't important.	Ꮭ ᎠᏎ ᎤᎵᏍᎨᏓ ᏱᎨᏍ ᎡᎢ.
I found a broken broom. He says he's broke.	ᎬᏃᏌᏍᏗ ᎤᎵᏍᏆᎵᏓ ᏥᏴᏩᏔ. ᏧᎵᏍᏆᎵᏓ ᎠᏗᎭ
Someone is sticking his head out of the window, but I don't know who it is.	ᎩᎶ ᏦᎳᏂ ᎤᎵᏍᏆᎷᏓ ᎠᏎᏅ Ꮭ ᏯᏆᏅᏔ ᎥᏍᎩ ᎨᏒᎢ.
I see him, he's wearing a different hat.	ᏂᎪᎸ ᏱᏥᎪ ᏄᏓᎴ ᎤᎵᏍᏇᏚᎪᎢ.
It's really dark tonight.	ᏙᏳ ᎤᎵᏏᎦ ᎪᎯ ᎤᏒᎢ.
It's hard to see someone in the dark if he has on a dark shirt.	ᏍᏓᏱ ᎠᎪᏩᏛᏗ ᎤᎵᏏᎬ ᎩᎶ ᎤᎵᏍᎩ ᏳᏄᏩ.
I have a yellow colored car.	ᏓᎶᏂᎨ ᎤᎵᏑᏫᏓ ᏓᏆᎴᎳ ᎠᎩᎭ.
I'm not allergic to poison ivy.	Ꮭ ᎪᎱᏍᏗ ᏯᏋᏁᎰ ᎤᎸᏓ.
I like her because she's friendly.	ᎤᏓᏅᏘᏴ ᎢᏳᏍᏗ ᏥᎸᏉᏗ.
She bought six water glasses.	ᏑᏓᎵ ᎢᎦ ᎠᎹ ᏧᏟᏍᏙᏗ ᏧᎸᏌᏗ ᏚᏩᏒᎢ.
Do you have a driver's license?	ᏣᎾᎠᏍ ᏓᏆᎴᎳ ᎠᎯᎵᏓᏍᏗ ᎠᏓᎵᏍᎪᎸᏓᏁᎯ ᎪᏪᎵ?
The chain broke as he was pulling the car.	ᏓᏆᎴᎳ ᎦᎾᏌᏁᏍᎬ ᏚᎵᎦᎵᏒ ᎤᎾᏓᏕᏒᏓ.
Let's go to the ball field.	ᎤᎾᎳᏍᎦᎸᏗ ᎢᏕᎾ.
My friend and I went to Texas together.	ᎣᎩᎾᎵ ᎣᎩᎾᎵᎪᎯ ᏬᎩᏁᏙᎸ ᏅᏓᎩᎢ.
I am going to go and visit my friend. 	ᎣᎩᎾᎵᎢ ᏫᏓᏥᏩᏛᎯᏙᎵ.
I saw her with her boyfriend a while ago.	ᎤᎾᎵᎪᏗ ᎤᎾᎵᎪᏒ ᏥᏥᎪᎥ ᎪᎯ.
Are you going to get a plaid shirt?	ᎤᎾᎶᎢᏓᏍ ᎠᎿᏬ ᏘᏁᏏ?
His white shirt got bloody when his nose started bleeding.	ᎩᎬᎭ ᏄᎵᏍᏔᏅ ᎤᏁᎦ ᎤᏄᏮ ᎩᎦ ᏚᏴᏍᏉᎳ.
His skin is just burned	ᎤᎪᏅᎢᏊ ᎤᏁᎦᎸᎢ.
He was hiding in an ugly house.	ᎤᏁᎩᎸᏗ ᎠᏓᏁᎸ ᎤᏗᏍᎦᏢᎢ.
Quit. You're being too mean.	ᏞᏍᏗ. Ꮩ ᏣᏁᎫᏣ. 
Watch yourself, they have a mean dog.	ᏣᏓᎦᏎᏍᏕᏍᏗ, ᎩᏟᏍ ᎤᏁᎫᏥᏓ ᎤᏁᎧᎭ.
I forgot to bring a blanket.	ᎤᏁᎬᎭ ᏂᏛᎩᎾᏫᏘᏗ ᎠᏋᎨᏫᏒᎢ.
I always have milk to sell.	ᏂᎪᎯᎸ ᎤᏅᏗ ᎠᎩᎾᏗᏅᏗ ᎠᎩᏁᎰᎢ.
The Bible says God's name is Jehovah.	ᏱᎰᏩ ᏚᏙᎠ ᎤᏁᏝᏅᎯ ᎠᏗᎭ ᎦᎸᏉᏗ ᎪᏪᎵ.
He went to town after some ice.	ᎤᏁᏍᏓᎳ ᎤᏯᎷᎦ ᏗᎦᏚᎲᎢ.
The snow stayed on the ground for a long time.	ᎪᎯᏓ ᎠᎲ ᎦᏙᎯ ᎤᏅᏥ.
Did he know that you were supposed to come today?	ᎤᏅᏖᎢᏍ ᎪᎯ ᎢᎦ ᏣᎷᎯᏍᏗ ᎨᏒ?
His grandfather raised him.	ᎤᏂᏏ ᎤᏛᎯᏍᏔᏅᎢ.
He's shearing the sheep with shears.	ᏗᎵᏍᏙᏱᏗ ᎬᏗ ᏓᏍᏙᏰ ᎤᏂᏃᏕᎾ.
A bell rings when it's time for church to start.	ᎤᎭᎸᏂ ᎤᏃᏴᎪ ᎤᏓᎴᏅᏗ ᏱᎩ ᏓᏂᎳᏫᎬᎢ.
A tornado went through a big city.	ᎤᏃᎴ ᎤᎯᎸᏍᏔᏅ ᎤᏔᎾ ᎦᏚᎲᎢ.
The month of January is the beginning of a new year.	ᎤᏃᎸᏔᎾ ᎧᎸ ᎠᏓᎴᏂᏍᎬ ᎢᏤ ᎠᏕᏘᏱᏍᎬᎢ.
He likes to drink milk.	ᎤᏅᏗ ᎤᎸᏉᏗ ᎤᏗᏔᏍᏗᎢ.
How big is the human brain?	ᎯᎳ ᏂᎧ ᏴᏫ ᎤᏅᏥᏓ?
He has on thin covers.	ᏧᏌᎨ ᏗᎿᎣᏬᏍᏙᏗ ᏚᎿᏬᏍᏗ.
She's ironing all of her dresses.	ᏂᎦᏓ ᏧᏌᏃ ᏓᏖᏍᎦ.
When he entered the cave, they didn't see him a second time.	ᎤᏍᏓᎦᎸ ᏭᏴᏝ, Ꮭ ᏔᎵᏁ ᏱᎤᏂᎪᎮᎢ.
Are there any crackers? 	ᏓᎭᏍ ᎦᏚ ᎤᏂᏍᏓᎦᏴᎯᏓ?
He cooked for his wife on her birthday.	ᎤᏍᏓᏴᎲᏍᎩ ᎤᏕᏘᏱᏍᎬ ᎤᏍᏓᏴᏅᎢ.
I hear a little baby crying.	ᎤᏍᏗ ᎠᏠᏱᎲ ᎦᏛᎩᎠ.
I like small cars better than big ones.	ᏧᏍᏗ ᏓᏆᎴᎳ ᎤᎪᏗ ᏓᎩᎸᏉᏗ ᏏᏅ ᏧᏔᎾ ᎨᏒᎢ.
He got lost walking through a trail. 	ᎤᏍᏗ ᎦᏅᏅ ᎠᎢᏒ ᎤᎴᎾᏢᎢ.
He's scratching his scalp.	ᎤᏍᏗᏁᎦᎸ ᎠᏜᎪᏍᎦ.
What is he being punished for?	ᎦᏙ ᎤᏛᏁᎸ ᎤᏍᏛᏗᎠ?
He barely lifed the heavy rock.	 ᏎᎦᏨ ᎤᏌᎳᏓᏅ ᎦᎨᏓ ᏅᏯ.
Some people are slow to get ready. Today seemed to go by slow.	ᎢᎦᏓ ᎤᏂᏍᎦᏃᎵ ᎨᏐ ᎤᎾᏛᏅᎢᏍᏙᏗᎢ. ᎤᏍᎦᏃᎵ ᎦᎶᎯ ᏂᎬᏩᏍᏗ ᎪᎯ ᎢᎦ.
The car has bright lights.	Ꮎ ᏓᏆᎴᎳ ᏧᏍᎪᏍᏗ ᏚᏨᏍᏔ.
They talk about interesting things when they talk.	ᎤᏍᏆᏂᎩᏗ ᎠᏂᏃᎮᎸᏍᎪ ᏳᏂᏬᏂᏌ.
He's rubbing his stomach.	ᎤᏍᏉᏟ ᎠᏍᎪᎵᏰᎠ.
Hand me an empty can.	ᎤᏏᏩ ᏔᎷᎩᏍᎩ ᎡᏍᎬᏏ.
He's coughing because he smokes too much.	ᏥᏈᏗ ᎪᎦᏍᎬ ᎢᏳᏍᏗ ᎤᏏᏩᏍᎦ.
He found a human skull while digging.	ᏴᏫ ᎤᏍᎧ ᎤᏩᏛᎲ ᎠᏍᎪᏍᎬᎢ.
The squirrel climbed to the top of the tree when the dog chased it.	ᏡᎬ ᎤᏍᎪᎵ ᏭᎶᏢ ᏌᎶᎵ ᎩᏟ ᎤᎨᎮᎾ.
He didn't even see me standing behind him.	Ꮭ ᏍᏊ ᏯᎩᎪᎮ ᎤᏐᏛ ᏥᏥᏙᎬᎢ.
Her hair is always clean.	ᏂᎪᎯᎸ ᎤᏓᏅᎦᎸᏓ ᎨᏐ ᎤᏍᏘᎬᎢ.
The cat's claws are sharp.	Ꮎ ᏪᏌ ᏚᏑᎦᏢ ᏗᎪᏍᏓᏱ.
Didn't he know he was wearing his pants inside out?	ᏝᏍ ᏳᏅᏖ ᎦᏁᎦᏔᏴᏓ ᎤᏑᎸᎢ? 
I wonder where he buys his pants?	ᎭᏢᏍᎩᏂ ᏚᏩᏍᎪ ᏧᏑᎶ?
He's cleaning his shotgun.	ᎤᏒᏕᎾ ᎤᏤᎵ ᎦᏅᎦᎵᎭ.
The water pipes froze last night.	ᎠᎹ ᏧᏪᏓᏍᏗ ᏧᏒᏙᏂ ᏚᏁᏍᏓᎳᏛ ᎤᏒ ᏥᎨᏒᎢ.
When are you going to bed?	ᎯᎳ ᎢᏴ ᏓᏨᏒᏟ?
My friend works during nights.	ᎣᎩᎾᎵᎢ ᎤᏒ ᏚᎸᏫᏍᏓᏁᎰᎢ.
I am thirsty for water.	ᎠᎹ ᎠᎩᏔᏕᎩᎠ
When he was called names, he becameenraged.	ᎪᎱᏍᏗ ᎠᎪᏎᎸᏁᎳ, ᎤᏔᏝᏬᏒᎢ.
He is building a big house.	ᎤᏔᎾ ᎦᎵᏦᏕ ᎠᏁᏍᎨᎭ.
This shirt is too big.	ᎤᏔ Ꮒ ᎯᎠ Ꭰ ᎿᏬ.
He got burned by steam.	ᎤᏔᏃᎸᏓ ᏚᎴᏴᏔᏅᎢ.
They're eating leftovers from yesterday.	ᏒᎯ ᎤᏘᏴᏅᎢ ᎠᏂᎩᎠ.
He broke his ankle when he jumped from a tree.	ᎤᏥᏆᎸᏛ ᎤᎵᏍᏆᎵᏎᎸ ᏡᎬ ᏙᏧᎵᏔᏗᎾ.
I don't like a crooked arrow.	Ꮭ ᏯᎩᎸᏉᏗ ᎤᏥᏈᏗ ᎦᏟᏓ.
It rained a lot yesterday.	ᎤᏥᏈᏍᏗ ᎤᎦᎿᏅ ᏒᎯ ᏥᎨᏒᎢ.
I hope to hear from her.	ᎤᏚᎩ ᎠᏋᎭ ᏥᏯᏛᎪᏗᎢ.
I like to listen to thunder.	ᎠᏴᏓᏆᎶᏍᎬ ᎠᏆᏛᏓᏍᏙᏗ ᎠᎩᎸᏉᏗ.
Who is the old chap?	ᎦᎪ Ꮎ ᎤᏛᎯᏍᏗ?
When a man becomes fully grown, they call him an old man.	ᎠᏍᎦᏯ ᏳᏛᏐᎿ, ᎤᏛᏐᏅ ᎠᏃᏎᎰᎢ.
Someone is hiding behind the bushes.	ᏚᏩᎢᏢ ᎤᏟ ᏗᏜ ᎤᏗᏍᎦᏝ ᎩᎶᎢ.
What do you use to take fish scales off?	ᎦᏙ ᎤᏍᏗ ᎲᏗᏍᎪ ᏅᏅᏕᏍᎩ ᎠᏣᏗ ᎤᏩᏥᏍᎦᏢᎢ?
Just forget about it.	ᏫᏨᎨᏩᏊ.
Whenever he eats a lot, he belches.	ᏥᏈᏍᏗ ᏳᎵᏓᏴᎿ, ᎤᏩᎫᎴᎪᎢ.
She's shivering because she's cold.	ᎧᎾᏬᎬ ᎢᏳᏍᏗ, ᎤᎠᎾᏫᎠ.
Do you have any ripe cantaloupes?	ᎠᏂᏩᏒᎩᏍ ᎤᏅᏂᏒ ᏕᏣᎭ?
She's wearing a sweater made from wool.	ᎤᏩᏂ ᎪᏢᏔᏅ ᎠᎿᏩ ᎤᏄᏩ.
Owls like to sit on limbs.	ᏚᏩᏂᎦᏢ ᎤᎾᎩᎸᏗ ᎤᏂᎸᏉᏗ ᏩᎱᎯ.
Why are you in such a hurry?	ᎦᏙ ᏂᎦ ᏨᏅᎦ?
He came by himself. Only he knows what happened	ᎤᏩᏌ ᎤᎷᏨᎢ. ᎤᏩᏌ ᎤᏅᏔ ᏄᎵᏍᏔᏂᏙᎸᎢ.
His hands became numb when they became cold.	ᏧᏩᏒᎯ ᏂᏚᎵᏍᏔᏅ ᏧᏬᏰᏂ ᏚᏴᏜᏕᎳ.
He says he smells something strong.	ᎪᎱᏍᏗ ᎤᏴᏍᏗ ᎤᏩᏩᏍᎦ ᎠᏗᎭ.
I have a shotgun.	ᎦᎶᏇ ᎤᏒᏕᎾ ᎠᏋᏯ.
When he applauds, his hand hurts.	ᏱᏚᏏᏛᎯᎳ, ᎤᏪᏲᏂ ᎤᏪᎯᏍᏓᏁᎰᎢ.
Wolves howled all night last night.	ᎤᎵᏨᏓᏆᏓ ᎤᏁᏡᏅ ᏩᏯ ᎤᏒ ᏥᎨᏒᎢ.
How did he become wealthy?	ᎦᏙ ᎠᏛᏁᎲ ᎤᏪᎿᎢ ᏄᎵᏍᏔᏁᎢ?
How much are a dozen eggs?	ᎯᎳ ᏧᎬᏩᎵᏗ ᏌᏊ ᎢᎠᎳᏚ ᏧᏪᏥ?
He's going to go visit his sons.	ᏧᏪᏥ ᎠᏂᏧᏣ ᏓᏩᏛᎮᎦ.
He's looking for his son.	ᎤᏪᏥ ᎠᏧᏣ ᎠᏯᎭ.
The mother and her daughter look alike.	Ꮎ ᎤᏓᏥ ᎤᏪᏥᏅᎠᎨᏯ ᎤᏂᏠᏱ ᏗᎨᎦᎦᏅᏗᎢ
His daughter is graduating this summer.	ᎤᏪᏥ ᎠᎨᏳᏣ ᏓᏍᏆᏗᎠ ᎪᎯ ᎪᎩ.
Who did his son marry?	ᎦᎪ ᎤᏯᏅᎮ ᎤᏪᏥ ᎠᏍᎦᏯ?
He has a mean dog.	ᎩᏟ ᎤᎿᎸᎯ ᎤᏪᎧᎭ.
She's cooking liver.	ᎤᏪᎳ ᎬᏂᏍᏗᎭ.
Don't worry.	ᏞᏍᏗ ᏱᏤᎵᎯᏍᎨᏍᏗ.
He felt worried when he heard that his father was sick.	ᎤᏪᎵᎯᏍᏗ ᎤᏓᏅᏓᏛᎢ ᎤᏛᎦᎾ ᎤᏙᏓ ᎤᏢᎬᎢ.
He has an old heating stove.	ᎤᏪᏘ ᎣᏏ ᎠᎦᎾᏬᎯᏍᏗ ᎤᎭ.
I couldn't cross the river because it was too swift.	ᎠᎩᏄᎸᏅ ᏗᎩᏐᎯᏍᏗ ᎤᏪᏴᎢ ᏍᏓᏱ ᎦᏃᎱᎩᏍᎬ ᎢᏳᏍᏗ.
She hung the damp clothes on the line.	ᎠᏏᎳᏛ ᏚᎸᏅ ᏧᏬᏕᏫᏓ ᏗᎿᏬ.
There goes a brown car.	ᎤᏬᏗᎨ ᏓᏆᎴᎳ ᎾᏟ.
She was given a pretty car when she graduated.	ᎤᏬᏚᎯ ᏓᏆᎴᎳ ᎠᏥᏁᎸ ᏚᏍᏆᏓ.
He want's to play with foam.	ᎤᏬᎩᏟ ᏧᏁᎶᏙᏗ ᎤᏚᎵᎭ.
He's always confident that he's doing the right thing. Have faith.	ᎤᏬᎯᏳᏐ ᏚᏳᎪᏛ ᎾᏛᏁᎲᎢ. ᏦᎯᏳᏎᏍᏗ.
1. Where will you be sitting? 2. Is your brother home?	1. ᎭᏢ ᎢᏴ ᏦᏞᏍᏗ? 2. ᎤᏬᏝᏍ ᏗᏍᏓᏓᏅᏟ?
He dived from a bluff.	ᎤᏬᏝᎥᎢ ᏓᎤᏕᏘᏅᎢ.
The old man is telling funny stories.	ᎤᏬᎵᏗ ᎧᏃᎮᏢᏍᎦ ᎤᏛᏐᏅᎢ.
My ankle is swollen.	ᎤᏬᏘᏓ ᎠᎩᏥᏆᎸᏛᎢ.
He greeted him with his hand.	ᎤᏬᏰᏂ ᎬᏗ ᎤᏲᎵᎸᎢ.
I see something furry.	ᎪᎱᏍᏗ ᎤᏭᏯᏘ ᏥᎪᏩᏘᎭ.
He wants to talk with you for some reason.	ᎪᎱᏍᏗ ᎤᏰᎸᏗ ᏍᏓᏟᏃᎡᏗ ᎤᏚᎵᎭ.
He stopped the car suddenly.	ᎤᏰᎶᎢᏍᏗ ᎤᎴᏫᏍᏙᏔᏅ ᏓᏆᎴᎳ.
He swam naked in the creek.	ᎤᏰᎸᎭ ᎤᏙᏬᎥ ᎤᏪᏴᎢ.
Why are you laughing?	ᎦᏙ ᏥᏣᏰᏘᏍᎦ?
I'm itching where something bit me.	ᎪᏍᏗ ᎠᎩᏍᎦᎵᏨ ᎠᎩᏲᏕᎠ.
He lost his watch underwater.	ᎠᎹᏱ ᎭᏫᎾ ᎤᏲᎱᏎᎸ ᏩᏥ.
Why are some people afraid of dead people?	ᎦᏙ ᎢᎦᏓ ᏧᏂᏲᎱᏒ ᏥᏓᏂᏍᎦᎰ?
His bicycle broke down on a bad road.	ᎤᏲ ᎦᏅᏅ ᎤᏲᏤᎸ ᏔᎵ ᏗᎦᏆᏘ.
He's picking up a broken glass. She has a very spoiled child.	ᎤᎸᏌᏗ ᎤᏲᏨ ᎫᏖᎠ. ᎤᏙᎯᏳ ᎤᏲᏨ ᎠᏲᏟ ᎤᏪᎧᎭ.
I didn't eat this morning and now I'm hungry.	Ꮭ ᏯᏆᎵᏍᏓᏴᏁ ᏑᎾᎴ, ᏃᏊᏅ ᎠᎩᏲᏏᎭ.
Let's go fishing at the pond.	ᎥᏓᎵ ᎢᎾᏑᏄᎦ.
He caught a bad disease.	ᎤᏍᎦᏎᏗ ᎥᏳᎩ ᎤᏂᏴᎲᎢ.
Some say that locusts are good to eat	ᎥᎴ ᎠᏃᏍᏓ ᏗᎦᏰᏍᏗ ᎠᎾᏗᏍᎪ ᎢᎦᏓ.
The house cost too much; therefore I didn't buy it.	ᏥᏈᏍᏗ ᎤᎬᏩᎶᏗ ᎨᏒ ᎦᎵᏦᏕ; ᎥᏍᎩᏅ ᎢᏳᏍᏗ Ꮭ ᏯᎩᏩᏎᎢ.
Christmas is in the month of December.	ᎥᏍᎩᏱ ᎧᎸ ᎨᏐ ᏗᏂᏍᏓᏲᎯᎲᎢ.
What would happen if they did that?	ᎦᏙ ᏱᎦᎵᏍᏓ ᎥᏍᎩᎾ ᏱᏄᎾᏛᏁᎳ?
Dragonflies fly around close to a pond	ᎥᏓᎵ ᎾᎥ ᎠᏂᏃᎯᎵᏙᎰ ᏩᏓᏚᎦ.
Where do you want me to send this box?	ᎭᏢ ᏩᎩᏏᏍᏗ ᏣᏚᎵ ᎯᎠ ᎧᏁᏌᎢ?
Bees make honey.	ᏩᏚᎵᏏ ᎠᏃᏢᏍᎪ ᏩᏚᎵᏏ.
He cut a blood vessel when he cut himself on the foot with an axe.	ᏩᏚᎾ ᎤᎦᎵᏍᏔᏅ ᎤᎳᏏᏕᏂ ᎤᏓᎷᏯ.
This man owns a lot of cows.	ᎯᎠ ᎠᏍᎦᏯ ᏥᏈᏍᏗ ᏩᎦ ᏚᎾᏝᎠ.
I like to eat beef.	ᏩᎦ ᎭᏫᏯ ᎠᎩᎸᏉᏗ ᎠᎩᎩᏍᏗ
I know a girl whose last name is Owl.	ᏩᎱᎯ ᏭᏍᏕᎵᏗ ᎠᎨᏳᏣ ᏥᏲᎵᎩ.
He sent the Christmas gift on December the 24th.	ᎥᏍᎩᏱ ᏔᎵᏍᎪ ᏅᎩᏁ ᏭᏅ ᏓᏂᏍᏓᏲᎯᎲ ᎠᏓᏁᏗ.
Wolves are dangerous when they're hungry.	ᏩᏯ ᏱᏚᏂᏲᏏ ᎠᏂᎾᏰᎪᎢ.
What time does the clock say?	ᎯᎳ ᎠᏟᎢᎵ ᎠᏗᎭ ᏩᏥ?
If you swallow saliva while running, it tires you out.	ᏩᏥᎳ ᏴᎩᏍᎦ ᎥᏟᏒ, ᏙᏯᏪᎢᏍᏗᏍᎪᎢ.
I'm heading for town.	ᏗᎦᏚᎲ ᏫᏥᎦᏘ.
Hummingbirds cannot walk.	ᏩᎴᎠ Ꮭ ᎠᏁᏙᎯ ᏱᎩ
The frogs are croaking.	ᏩᎶᏏ ᎾᏂᏪᎠ.
He's chopping on a hickory tree.	ᏩᏁᎢ ᏡᎬᎢ ᎦᎷᏯᏍᎪ.
She likes to use a soft pillow.	ᏩᏂᎨ ᎠᏆᏍᏙ ᎤᏮᏙᏗ ᎤᎸᏉᏗ.
She thought it was a moth, but it was a butterfly.	ᏩᏐᏝ ᎤᏪᎵᏒ ᎠᏎᏅ ᎧᎹᎹ ᎨᏒᎢ.
Do you know anyone named Washington?	ᎯᏲᎵᎩᏍ ᎩᎶ ᏩᏒᏓᎾ ᎤᏙᎢᏓ?
Have you been to Washington?	ᏤᏙᎸᎢᏍ ᏩᏒᏓᏃᎢ?
Did you see a cat?	ᏪᏌᏍ ᎯᎪᏩᏘ?
Whenever she goes somewhere, she takes her child to her neighbor.	Ꮲ ᏰᎦ, ᎾᎥ ᎢᏧᎾᏓᎵ ᏗᎦᏁᎸ ᏫᎦᎧᎲᏍᎪᎢ ᎤᏪᏥ ᎠᏲᏟ.
She took the glass of water inside.	ᎦᎵᏦᏕ ᏭᏁᏅ ᎠᎹ ᎠᏟᏍᏛ ᎤᎸᏌᏗ.
When his son asked him for some money, he sent him a twenty dollar bill.	ᎠᏕᎳ ᏧᏔᏲᏎᎳ ᎤᏪᏥ ᏔᎵᏍᎪ ᎠᏕᎸ ᏭᏅᏁᎸᎢ.
Some pigeons are message carriers.	ᎧᏃᎮᏓ ᎠᏂᎯᏙᎯ ᎢᎦᏓ ᏬᏱ.
The sun goes out of sight in the west.	ᏭᏕᎵᎦ ᎢᏗᏜ ᏭᏕᎵᎪ ᎢᎦ ᎡᎯ ᏅᏓ.
Clouds are forming in the west.	ᏭᏕᎵᎬ ᎢᏗᏜ ᏗᎦᎶᎩᎳᏗᎠ.
What do you want me to do with the rest of the money?	ᎦᏙ ᏗᏋᏁᏗ ᏣᏚᎵ ᏭᏅᎦᏗ ᎠᏕᎳ?
The buffalo is almost extinct.	ᏯᏂᏌ ᎤᎾᏨᏂᏗ.
He goes wherever he wants to go anytime.	ᏱᏂᎦᎵᏍᏗᎭᏊ ᎢᎸᏢ ᎤᏪᏅᏍᏗ ᏳᏚᎵ ᎡᎪ ᏱᏂᎦᎵᏍᏗᎭᏊ ᎢᏴᎢ?
You may choose anyone to help you.	ᏱᏂᎦᎵᏍᏗᎭᏊ ᎩᎶ ᎯᏯᏑᏰᏍᏗ ᏣᏍᏕᎵᏍᎩ.
Have you seen anyone wrestle a bear?	ᎯᎪᎥᎢᏍ ᎩᎶ ᏲᎾ ᎠᏁᏍᏗᏍᎬᎢ?
That white man is speaking English.	Ꮎ ᎠᏲᏁᎦ ᏲᏁᎦ ᎦᏬᏂᎭ.
Sometimes things don't turn out the way I want them to.	ᏳᏓᎭ Ꮭ ᎠᏆᏚᎵᏍᎬ ᏱᏂᎦᎵᏍᏗᏍᎪ.
He broke his hammer driving a nail.	ᎦᏅᏆᎶᏍᏗ ᎤᏲᏤᎸ ᏴᎩ ᎦᎭᏛᏍᎬᎢ.
Long ago Cherokees used to tell stories about cannibals.	ᎪᎯᎩᏴ ᏥᎨᏒ ᎠᏂᏴᏩᎩᏍᎩ ᏓᏂᏃᏁᏍᎬ ᎠᏂᏣᎳᎩ.
